Name,Accuracy,TrainTime,TestTime,Dimensions,Method,Encoding,Iterations
Abalone,0.3362068831920624,2.568108081817627,4.900209903717041,10000,add,bundle,1
AcuteInflammation,0.6666666865348816,0.05451512336730957,0.14989709854125977,10000,add,bundle,1
AcuteNephritis,0.800000011920929,0.08016633987426758,0.09114384651184082,10000,add,bundle,1
Adult,0.7637737393379211,28.33017587661743,50.303993463516235,10000,add,bundle,1
Annealing,0.0,1.0432887077331543,0.49724864959716797,10000,add,bundle,1
Arrhythmia,0.5840708017349243,0.21480059623718262,0.5662932395935059,10000,add,bundle,1
AudiologyStd,0.4399999976158142,0.1201622486114502,0.12738513946533203,10000,add,bundle,1
BalanceScale,0.38461539149284363,0.42333030700683594,0.6553418636322021,10000,add,bundle,1
Balloons,0.5,0.00817418098449707,0.010108470916748047,10000,add,bundle,1
Bank,0.8849557638168335,2.2539138793945312,3.7922563552856445,10000,add,bundle,1
Blood,0.759358286857605,0.6409921646118164,0.9019687175750732,10000,add,bundle,1
BreastCancer,0.28169015049934387,0.20567846298217773,0.13910508155822754,10000,add,bundle,1
BreastCancerWisc,0.7200000286102295,0.6775665283203125,0.41027402877807617,10000,add,bundle,1
BreastCancerWiscDiag,0.6267605423927307,0.5439467430114746,0.6771607398986816,10000,add,bundle,1
BreastCancerWiscProg,0.7755101919174194,0.13549089431762695,0.2428112030029297,10000,add,bundle,1
BreastTissue,0.19230769574642181,0.06585383415222168,0.08941316604614258,10000,add,bundle,1
Car,0.6273148059844971,1.0269019603729248,1.1256799697875977,10000,add,bundle,1
Cardiotocography10Clases,0.1807909607887268,1.4382762908935547,1.6282265186309814,10000,add,bundle,1
Cardiotocography3Clases,0.7796609997749329,1.7841122150421143,2.1102256774902344,10000,add,bundle,1
ChessKrvk,0.012118619866669178,23.277458429336548,25.729607820510864,10000,add,bundle,1
ChessKrvkp,0.4768460690975189,2.6134681701660156,3.009369134902954,10000,add,bundle,1
CongressionalVoting,0.3761467933654785,0.3872060775756836,0.51924729347229,10000,add,bundle,1
ConnBenchSonarMinesRocks,0.5384615659713745,0.13619327545166016,0.259432315826416,10000,add,bundle,1
ConnBenchVowelDeterding,0.09090909361839294,0.6677055358886719,2.111423969268799,10000,add,bundle,1
Connect4,0.7538042664527893,44.12469410896301,52.58779740333557,10000,add,bundle,1
Contrac,0.426630437374115,1.1558237075805664,1.034224271774292,10000,add,bundle,1
CreditApproval,0.44186046719551086,0.6300368309020996,0.46788859367370605,10000,add,bundle,1
CylinderBands,0.390625,0.48101043701171875,0.5795702934265137,10000,add,bundle,1
Dermatology,0.3076923191547394,0.36451077461242676,0.3865971565246582,10000,add,bundle,1
Echocardiogram,0.6969696879386902,0.08895397186279297,0.16542482376098633,10000,add,bundle,1
Ecoli,0.4523809552192688,0.28252530097961426,0.4083225727081299,10000,add,bundle,1
EnergyY1,0.2083333283662796,0.7294955253601074,0.45414066314697266,10000,add,bundle,1
EnergyY2,0.2760416567325592,0.7356390953063965,0.313295841217041,10000,add,bundle,1
Fertility,0.36000001430511475,0.09775757789611816,0.12594342231750488,10000,add,bundle,1
Flags,0.2083333283662796,0.15080595016479492,0.24016022682189941,10000,add,bundle,1
Glass,0.3207547068595886,0.1368248462677002,0.2624192237854004,10000,add,bundle,1
HabermanSurvival,0.7368420958518982,0.27648329734802246,0.3748779296875,10000,add,bundle,1
HayesRoth,0.5357142686843872,0.1814560890197754,0.1411895751953125,10000,add,bundle,1
HeartCleveland,0.5657894611358643,0.27646422386169434,0.3723180294036865,10000,add,bundle,1
HeartHungarian,0.6438356041908264,0.23233628273010254,0.2964589595794678,10000,add,bundle,1
HeartSwitzerland,0.06451612710952759,0.10975933074951172,0.13811397552490234,10000,add,bundle,1
HeartVa,0.03999999910593033,0.16813373565673828,0.08217120170593262,10000,add,bundle,1
Hepatitis,0.4615384638309479,0.13160037994384766,0.19532108306884766,10000,add,bundle,1
HillValley,0.5066006779670715,0.6031806468963623,1.7903790473937988,10000,add,bundle,1
HorseColic,0.6029411554336548,0.17818760871887207,0.09819746017456055,10000,add,bundle,1
IlpdIndianLiver,0.7191780805587769,0.5472772121429443,0.40322327613830566,10000,add,bundle,1
ImageSegmentation,0.1428571492433548,0.23177647590637207,6.6205644607543945,10000,add,bundle,1
Ionosphere,0.6931818127632141,0.3011782169342041,0.43823766708374023,10000,add,bundle,1
Iris,0.3513513505458832,0.13141298294067383,0.1195077896118164,10000,add,bundle,1
LedDisplay,0.18400000035762787,0.964712381362915,0.5478169918060303,10000,add,bundle,1
Lenses,0.1666666716337204,0.0180206298828125,0.02169179916381836,10000,add,bundle,1
Letter,0.039400000125169754,12.36973524093628,14.847496032714844,10000,add,bundle,1
Libras,0.06666667014360428,0.3127024173736572,0.45000553131103516,10000,add,bundle,1
LowResSpect,0.1654135286808014,0.2028365135192871,0.23720407485961914,10000,add,bundle,1
LungCancer,0.25,0.017482757568359375,0.018863439559936523,10000,add,bundle,1
Lymphography,0.0,0.0778508186340332,0.09826159477233887,10000,add,bundle,1
Magic,0.6483701467514038,12.192268371582031,18.39470362663269,10000,add,bundle,1
Mammographic,0.5375000238418579,0.7469766139984131,0.9877736568450928,10000,add,bundle,1
Miniboone,0.28060030937194824,84.9710054397583,106.1335916519165,10000,add,bundle,1
MolecBiolPromoter,0.5,0.04043722152709961,0.057625532150268555,10000,add,bundle,1
MolecBiolSplice,0.24592220783233643,1.7894344329833984,2.4214189052581787,10000,add,bundle,1
Monks1,0.5324074029922485,0.07910704612731934,1.288849115371704,10000,add,bundle,1
Monks2,0.6412037014961243,0.10944223403930664,1.3971049785614014,10000,add,bundle,1
Monks3,0.7129629850387573,0.08883309364318848,1.3556158542633057,10000,add,bundle,1
Mushroom,0.5179714560508728,5.192526340484619,5.99695086479187,10000,add,bundle,1
Musk1,0.5714285969734192,0.27326297760009766,0.4339559078216553,10000,add,bundle,1
Musk2,0.8459672331809998,4.530898332595825,4.712089538574219,10000,add,bundle,1
Nursery,0.1280864179134369,8.201978206634521,9.81877064704895,10000,add,bundle,1
OocytesMerlucciusNucleus4d,0.3294117748737335,0.6710550785064697,0.6654086112976074,10000,add,bundle,1
OocytesMerlucciusStates2f,0.250980406999588,0.817924976348877,0.7344481945037842,10000,add,bundle,1
OocytesTrisopterusNucleus2f,0.42105263471603394,0.6460177898406982,0.6875650882720947,10000,add,bundle,1
OocytesTrisopterusStates5b,0.5789473652839661,0.822810173034668,0.5002026557922363,10000,add,bundle,1
Optical,0.09905397891998291,3.0555410385131836,5.561302423477173,10000,add,bundle,1
Ozone,0.9716088175773621,1.6444361209869385,1.8782379627227783,10000,add,bundle,1
PageBlocks,0.8983917832374573,3.7331924438476562,3.847431182861328,10000,add,bundle,1
Parkinsons,0.26530611515045166,0.1521437168121338,0.23836588859558105,10000,add,bundle,1
Pendigits,0.1037735864520073,6.236740589141846,9.788285255432129,10000,add,bundle,1
Pima,0.6510416865348816,0.7244746685028076,0.4158916473388672,10000,add,bundle,1
PittsburgBridgesMaterial,0.3461538553237915,0.08411478996276855,0.13138818740844727,10000,add,bundle,1
PittsburgBridgesRelL,0.19230769574642181,0.0674445629119873,0.1131601333618164,10000,add,bundle,1
PittsburgBridgesSpan,0.260869562625885,0.06054878234863281,0.08809661865234375,10000,add,bundle,1
PittsburgBridgesTOrD,0.20000000298023224,0.08836698532104492,0.10083246231079102,10000,add,bundle,1
PittsburgBridgesType,0.19230769574642181,0.08542537689208984,0.12899541854858398,10000,add,bundle,1
Planning,0.7111111283302307,0.16127800941467285,0.22604727745056152,10000,add,bundle,1
PlantMargin,0.009999999776482582,0.7750246524810791,1.2876574993133545,10000,add,bundle,1
PlantShape,0.009999999776482582,0.7750692367553711,1.330510139465332,10000,add,bundle,1
PlantTexture,0.009999999776482582,1.084512710571289,1.40122389793396,10000,add,bundle,1
PostOperative,0.0,0.05654597282409668,0.1045992374420166,10000,add,bundle,1
PrimaryTumor,0.060975611209869385,0.21134018898010254,0.14440655708312988,10000,add,bundle,1
Ringnorm,0.4951351284980774,4.62460994720459,5.469265937805176,10000,add,bundle,1
Seeds,0.3461538553237915,0.1683053970336914,0.2609128952026367,10000,add,bundle,1
Semeion,0.11557789146900177,1.1922321319580078,1.0853614807128906,10000,add,bundle,1
Soybean,0.06648936122655869,0.29137206077575684,1.3941302299499512,10000,add,bundle,1
Spambase,0.6060869693756104,3.131451368331909,2.950993299484253,10000,add,bundle,1
Spect,0.6075268983840942,0.06686115264892578,0.7458257675170898,10000,add,bundle,1
Spectf,0.08021390438079834,0.07402396202087402,0.8593168258666992,10000,add,bundle,1
StatlogAustralianCredit,0.31976744532585144,0.6165368556976318,0.48987388610839844,10000,add,bundle,1
StatlogGermanCredit,0.699999988079071,0.8678891658782959,0.625537633895874,10000,add,bundle,1
StatlogHeart,0.5522388219833374,0.23418593406677246,0.18548202514648438,10000,add,bundle,1
StatlogImage,0.1473136842250824,1.420119285583496,1.6301708221435547,10000,add,bundle,1
StatlogLandsat,0.2304999977350235,3.451101303100586,5.9963579177856445,10000,add,bundle,1
StatlogShuttle,0.7915862202644348,42.83969855308533,61.29893350601196,10000,add,bundle,1
StatlogVehicle,0.2606635093688965,0.5627920627593994,1.0196750164031982,10000,add,bundle,1
SteelPlates,0.0804123729467392,1.7066450119018555,1.8869824409484863,10000,add,bundle,1
SyntheticControl,0.1666666716337204,0.3884007930755615,0.5159671306610107,10000,add,bundle,1
Teaching,0.42105263471603394,0.08212852478027344,0.190474271774292,10000,add,bundle,1
Thyroid,0.021295215934515,4.295067548751831,14.534799814224243,10000,add,bundle,1
TicTacToe,0.3472803235054016,0.7956783771514893,0.8968486785888672,10000,add,bundle,1
Titanic,0.5436363816261292,1.940403938293457,2.1149356365203857,10000,add,bundle,1
Trains,0.5,0.008619070053100586,0.008253812789916992,10000,add,bundle,1
Twonorm,0.500540554523468,6.535300254821777,8.0621018409729,10000,add,bundle,1
VertebralColumn2Clases,0.3246753215789795,0.2197873592376709,0.38710689544677734,10000,add,bundle,1
VertebralColumn3Clases,0.19480518996715546,0.2549889087677002,0.1983797550201416,10000,add,bundle,1
WallFollowing,0.4046920835971832,4.5632476806640625,6.2785046100616455,10000,add,bundle,1
Waveform,0.3312000036239624,4.437401294708252,5.2401123046875,10000,add,bundle,1
WaveformNoise,0.3391999900341034,4.357057094573975,5.563611030578613,10000,add,bundle,1
Wine,0.3181818127632141,0.1145939826965332,0.10201597213745117,10000,add,bundle,1
WineQualityRed,0.004999999888241291,1.496936559677124,1.5177359580993652,10000,add,bundle,1
WineQualityWhite,0.004084967542439699,4.041338205337524,5.0299060344696045,10000,add,bundle,1
Yeast,0.3207547068595886,1.3949377536773682,1.6677536964416504,10000,add,bundle,1
Zoo,0.3199999928474426,0.0822591781616211,0.12662720680236816,10000,add,bundle,1
Abalone,0.3362068831920624,3.4055826663970947,4.430998086929321,10000,add,sequence,1
AcuteInflammation,0.5333333611488342,0.07989144325256348,0.11478209495544434,10000,add,sequence,1
AcuteNephritis,0.6000000238418579,0.09635591506958008,0.15537714958190918,10000,add,sequence,1
Adult,0.7637737393379211,41.48897075653076,58.63576674461365,10000,add,sequence,1
Annealing,0.0,0.8998856544494629,0.14844536781311035,10000,add,sequence,1
Arrhythmia,0.5840708017349243,0.36502718925476074,0.36652088165283203,10000,add,sequence,1
AudiologyStd,0.4399999976158142,0.15718841552734375,0.13022804260253906,10000,add,sequence,1
BalanceScale,0.07692307978868484,0.6065044403076172,0.23250842094421387,10000,add,sequence,1
Balloons,0.75,0.009039640426635742,0.010643720626831055,10000,add,sequence,1
Bank,0.8849557638168335,2.877568006515503,3.1245059967041016,10000,add,sequence,1
Blood,0.7647058963775635,0.6929855346679688,0.27416014671325684,10000,add,sequence,1
BreastCancer,0.7042253613471985,0.3120255470275879,0.3652973175048828,10000,add,sequence,1
BreastCancerWisc,0.6571428775787354,0.4426555633544922,0.6549930572509766,10000,add,sequence,1
BreastCancerWiscDiag,0.6267605423927307,0.5984373092651367,0.4127194881439209,10000,add,sequence,1
BreastCancerWiscProg,0.7755101919174194,0.16781353950500488,0.25106167793273926,10000,add,sequence,1
BreastTissue,0.19230769574642181,0.09302973747253418,0.13486504554748535,10000,add,sequence,1
Car,0.03703703731298447,1.1274912357330322,1.3424506187438965,10000,add,sequence,1
Cardiotocography10Clases,0.1807909607887268,1.562349557876587,1.3327503204345703,10000,add,sequence,1
Cardiotocography3Clases,0.7796609997749329,1.5989656448364258,1.5045232772827148,10000,add,sequence,1
ChessKrvk,0.0996578261256218,18.317389965057373,19.14695644378662,10000,add,sequence,1
ChessKrvkp,0.4768460690975189,1.7611079216003418,2.025932550430298,10000,add,sequence,1
CongressionalVoting,0.6146789193153381,0.29773831367492676,0.5574302673339844,10000,add,sequence,1
ConnBenchSonarMinesRocks,0.5384615659713745,0.15254974365234375,0.1594829559326172,10000,add,sequence,1
ConnBenchVowelDeterding,0.09090909361839294,0.7372591495513916,1.1192505359649658,10000,add,sequence,1
Connect4,0.7538042664527893,49.74917221069336,60.273263931274414,10000,add,sequence,1
Contrac,0.42934781312942505,1.0646257400512695,1.102703332901001,10000,add,sequence,1
CreditApproval,0.44186046719551086,0.7131147384643555,0.2557506561279297,10000,add,sequence,1
CylinderBands,0.390625,0.5579078197479248,0.2170391082763672,10000,add,sequence,1
Dermatology,0.3076923191547394,0.3751530647277832,0.4670395851135254,10000,add,sequence,1
Echocardiogram,0.6969696879386902,0.06766796112060547,0.07936835289001465,10000,add,sequence,1
Ecoli,0.4523809552192688,0.309356689453125,0.1945936679840088,10000,add,sequence,1
EnergyY1,0.4739583432674408,0.4945230484008789,0.46135592460632324,10000,add,sequence,1
EnergyY2,0.5,0.5265636444091797,0.5194506645202637,10000,add,sequence,1
Fertility,0.8799999952316284,0.07213664054870605,0.1224982738494873,10000,add,sequence,1
Flags,0.2083333283662796,0.13394665718078613,0.07331204414367676,10000,add,sequence,1
Glass,0.3207547068595886,0.2221355438232422,0.270827054977417,10000,add,sequence,1
HabermanSurvival,0.7368420958518982,0.30692267417907715,0.17486858367919922,10000,add,sequence,1
HayesRoth,0.5,0.17822551727294922,0.14464092254638672,10000,add,sequence,1
HeartCleveland,0.5657894611358643,0.324690580368042,0.2806830406188965,10000,add,sequence,1
HeartHungarian,0.6438356041908264,0.2975730895996094,0.37373781204223633,10000,add,sequence,1
HeartSwitzerland,0.06451612710952759,0.11504769325256348,0.14459562301635742,10000,add,sequence,1
HeartVa,0.23999999463558197,0.1898350715637207,0.2541697025299072,10000,add,sequence,1
Hepatitis,0.20512820780277252,0.11365127563476562,0.1916036605834961,10000,add,sequence,1
HillValley,0.49339935183525085,0.30964183807373047,2.0846598148345947,10000,add,sequence,1
HorseColic,0.6029411554336548,0.40074634552001953,0.33794474601745605,10000,add,sequence,1
IlpdIndianLiver,0.7191780805587769,0.5661864280700684,0.512676477432251,10000,add,sequence,1
ImageSegmentation,0.1428571492433548,0.24002552032470703,6.121294260025024,10000,add,sequence,1
Ionosphere,0.35227271914482117,0.195969820022583,0.1307373046875,10000,add,sequence,1
Iris,0.3513513505458832,0.10379815101623535,0.08674311637878418,10000,add,sequence,1
LedDisplay,0.09600000083446503,0.9874415397644043,0.5880603790283203,10000,add,sequence,1
Lenses,0.1666666716337204,0.02042222023010254,0.022442102432250977,10000,add,sequence,1
Letter,0.039400000125169754,13.822728395462036,14.24465560913086,10000,add,sequence,1
Libras,0.06666667014360428,0.3341090679168701,0.4605224132537842,10000,add,sequence,1
LowResSpect,0.1654135286808014,0.44243812561035156,0.6557426452636719,10000,add,sequence,1
LungCancer,0.25,0.01959681510925293,0.01994180679321289,10000,add,sequence,1
Lymphography,0.0,0.11271047592163086,0.19115614891052246,10000,add,sequence,1
Magic,0.6483701467514038,13.735159873962402,18.75594449043274,10000,add,sequence,1
Mammographic,0.5375000238418579,0.9735591411590576,1.0205769538879395,10000,add,sequence,1
Miniboone,0.28060030937194824,89.98214769363403,132.37152886390686,10000,add,sequence,1
MolecBiolPromoter,0.5,0.04491162300109863,0.04464316368103027,10000,add,sequence,1
MolecBiolSplice,0.23964868485927582,2.8871800899505615,3.694223642349243,10000,add,sequence,1
Monks1,0.5,0.10685849189758301,1.908116102218628,10000,add,sequence,1
Monks2,0.6712962985038757,0.20591497421264648,1.9722638130187988,10000,add,sequence,1
Monks3,0.4722222089767456,0.09391140937805176,1.7478318214416504,10000,add,sequence,1
Mushroom,0.5179714560508728,7.466406583786011,9.222049951553345,10000,add,sequence,1
Musk1,0.5714285969734192,0.31340789794921875,0.5926773548126221,10000,add,sequence,1
Musk2,0.8459672331809998,5.824235200881958,7.602937698364258,10000,add,sequence,1
Nursery,0.33364197611808777,11.943138360977173,11.13115119934082,10000,add,sequence,1
OocytesMerlucciusNucleus4d,0.3294117748737335,0.9753806591033936,0.4451737403869629,10000,add,sequence,1
OocytesMerlucciusStates2f,0.250980406999588,0.5261547565460205,0.8495612144470215,10000,add,sequence,1
OocytesTrisopterusNucleus2f,0.42105263471603394,0.9056689739227295,0.3578789234161377,10000,add,sequence,1
OocytesTrisopterusStates5b,0.5789473652839661,0.7042801380157471,0.5977480411529541,10000,add,sequence,1
Optical,0.09905397891998291,3.1858067512512207,5.8940348625183105,10000,add,sequence,1
Ozone,0.9716088175773621,2.4067795276641846,2.5727429389953613,10000,add,sequence,1
PageBlocks,0.8983917832374573,4.009227752685547,4.035141229629517,10000,add,sequence,1
Parkinsons,0.2448979616165161,0.09829044342041016,0.22136187553405762,10000,add,sequence,1
Pendigits,0.1037735864520073,6.546045780181885,10.33098554611206,10000,add,sequence,1
Pima,0.6510416865348816,0.6446218490600586,0.28752946853637695,10000,add,sequence,1
PittsburgBridgesMaterial,0.1538461595773697,0.08101344108581543,0.1344916820526123,10000,add,sequence,1
PittsburgBridgesRelL,0.3076923191547394,0.08185720443725586,0.13434624671936035,10000,add,sequence,1
PittsburgBridgesSpan,0.21739129722118378,0.06472206115722656,0.06828665733337402,10000,add,sequence,1
PittsburgBridgesTOrD,0.8799999952316284,0.09967875480651855,0.1287081241607666,10000,add,sequence,1
PittsburgBridgesType,0.1538461595773697,0.0796654224395752,0.13012933731079102,10000,add,sequence,1
Planning,0.7111111283302307,0.1475226879119873,0.23446369171142578,10000,add,sequence,1
PlantMargin,0.009999999776482582,0.9468176364898682,0.8849976062774658,10000,add,sequence,1
PlantShape,0.009999999776482582,1.2128875255584717,1.7522356510162354,10000,add,sequence,1
PlantTexture,0.009999999776482582,1.3343734741210938,1.839421272277832,10000,add,sequence,1
PostOperative,0.7272727489471436,0.04349851608276367,0.08051323890686035,10000,add,sequence,1
PrimaryTumor,0.3048780560493469,0.22973895072937012,0.42160701751708984,10000,add,sequence,1
Ringnorm,0.4951351284980774,5.183464288711548,5.109066009521484,10000,add,sequence,1
Seeds,0.3461538553237915,0.1705946922302246,0.2678039073944092,10000,add,sequence,1
Semeion,0.10050251334905624,1.2178430557250977,1.1770298480987549,10000,add,sequence,1
Soybean,0.06648936122655869,0.2768702507019043,0.8773064613342285,10000,add,sequence,1
Spambase,0.6060869693756104,2.922579526901245,2.680568218231201,10000,add,sequence,1
Spect,0.5483871102333069,0.055391788482666016,0.7775764465332031,10000,add,sequence,1
Spectf,0.08021390438079834,0.08973121643066406,0.8631753921508789,10000,add,sequence,1
StatlogAustralianCredit,0.31976744532585144,0.7444984912872314,0.39832544326782227,10000,add,sequence,1
StatlogGermanCredit,0.699999988079071,0.8692116737365723,0.665337085723877,10000,add,sequence,1
StatlogHeart,0.5522388219833374,0.23911404609680176,0.10091876983642578,10000,add,sequence,1
StatlogImage,0.1473136842250824,1.7269537448883057,1.9142720699310303,10000,add,sequence,1
StatlogLandsat,0.2304999977350235,3.943981647491455,6.236868858337402,10000,add,sequence,1
StatlogShuttle,0.7915862202644348,37.178322553634644,41.764825105667114,10000,add,sequence,1
StatlogVehicle,0.2606635093688965,0.9101316928863525,0.316028356552124,10000,add,sequence,1
SteelPlates,0.0804123729467392,1.2911691665649414,1.4289917945861816,10000,add,sequence,1
SyntheticControl,0.1666666716337204,0.6154284477233887,0.41704702377319336,10000,add,sequence,1
Teaching,0.31578946113586426,0.08298563957214355,0.12603044509887695,10000,add,sequence,1
Thyroid,0.021295215934515,3.5752675533294678,9.47894549369812,10000,add,sequence,1
TicTacToe,0.3472803235054016,0.6576082706451416,0.8035457134246826,10000,add,sequence,1
Titanic,0.6781818270683289,1.5338425636291504,1.6179842948913574,10000,add,sequence,1
Trains,0.5,0.00906825065612793,0.008265972137451172,10000,add,sequence,1
Twonorm,0.500540554523468,4.949617385864258,5.201602935791016,10000,add,sequence,1
VertebralColumn2Clases,0.6753246784210205,0.23873543739318848,0.34291601181030273,10000,add,sequence,1
VertebralColumn3Clases,0.19480518996715546,0.30501413345336914,0.39487385749816895,10000,add,sequence,1
WallFollowing,0.4046920835971832,3.0309228897094727,3.5475590229034424,10000,add,sequence,1
Waveform,0.3312000036239624,3.6216564178466797,3.3461320400238037,10000,add,sequence,1
WaveformNoise,0.3391999900341034,3.528048276901245,3.194791555404663,10000,add,sequence,1
Wine,0.3181818127632141,0.1934525966644287,0.22686314582824707,10000,add,sequence,1
WineQualityRed,0.004999999888241291,0.9593014717102051,1.2160077095031738,10000,add,sequence,1
WineQualityWhite,0.004084967542439699,3.6067233085632324,3.5024075508117676,10000,add,sequence,1
Yeast,0.3207547068595886,1.0787353515625,1.3533260822296143,10000,add,sequence,1
Zoo,0.4399999976158142,0.06745266914367676,0.13018202781677246,10000,add,sequence,1
Abalone,0.31992337107658386,3.240171432495117,3.0625972747802734,10000,add,ngram,1
AcuteInflammation,0.8666666746139526,0.13562369346618652,0.16552495956420898,10000,add,ngram,1
AcuteNephritis,1.0,0.10583829879760742,0.14556121826171875,10000,add,ngram,1
Adult,0.7634665966033936,37.1496787071228,49.922845125198364,10000,add,ngram,1
Annealing,0.009999999776482582,1.079035758972168,0.15874934196472168,10000,add,ngram,1
Arrhythmia,0.5840708017349243,0.5713543891906738,0.21706700325012207,10000,add,ngram,1
AudiologyStd,0.4399999976158142,0.254849910736084,0.13988351821899414,10000,add,ngram,1
BalanceScale,0.5128205418586731,0.4540250301361084,0.2735166549682617,10000,add,ngram,1
Balloons,0.5,0.011580228805541992,0.011456966400146484,10000,add,ngram,1
Bank,0.8044247627258301,4.070856809616089,3.542041778564453,10000,add,ngram,1
Blood,0.7540106773376465,0.9418585300445557,0.4490830898284912,10000,add,ngram,1
BreastCancer,0.6056337952613831,0.40894651412963867,0.27595067024230957,10000,add,ngram,1
BreastCancerWisc,0.7657142877578735,0.8733570575714111,0.27617883682250977,10000,add,ngram,1
BreastCancerWiscDiag,0.6267605423927307,0.6973955631256104,0.22394800186157227,10000,add,ngram,1
BreastCancerWiscProg,0.7755101919174194,0.2341313362121582,0.26967740058898926,10000,add,ngram,1
BreastTissue,0.23076923191547394,0.1197206974029541,0.0979619026184082,10000,add,ngram,1
Car,0.5787037014961243,1.6524455547332764,1.3779771327972412,10000,add,ngram,1
Cardiotocography10Clases,0.1807909607887268,2.0406992435455322,1.5347025394439697,10000,add,ngram,1
Cardiotocography3Clases,0.7796609997749329,1.5352392196655273,1.7771751880645752,10000,add,ngram,1
ChessKrvk,0.056601084768772125,22.9392032623291,22.015146255493164,10000,add,ngram,1
ChessKrvkp,0.5018773674964905,2.906928300857544,3.567190408706665,10000,add,ngram,1
CongressionalVoting,0.3669724762439728,0.43239378929138184,0.547480583190918,10000,add,ngram,1
ConnBenchSonarMinesRocks,0.5384615659713745,0.15799427032470703,0.24893474578857422,10000,add,ngram,1
ConnBenchVowelDeterding,0.09090909361839294,0.9059770107269287,2.094303846359253,10000,add,ngram,1
Connect4,0.7538042664527893,82.30510473251343,77.0899407863617,10000,add,ngram,1
Contrac,0.40760868787765503,1.8799333572387695,1.8586554527282715,10000,add,ngram,1
CreditApproval,0.5465116500854492,0.8479733467102051,0.9178404808044434,10000,add,ngram,1
CylinderBands,0.390625,0.6398105621337891,0.619840145111084,10000,add,ngram,1
Dermatology,0.18681319057941437,0.4502544403076172,0.41915345191955566,10000,add,ngram,1
Echocardiogram,0.3030303120613098,0.08754897117614746,0.16335248947143555,10000,add,ngram,1
Ecoli,0.4642857015132904,0.38363218307495117,0.3666398525238037,10000,add,ngram,1
EnergyY1,0.4270833432674408,0.96502685546875,0.8546500205993652,10000,add,ngram,1
EnergyY2,0.3854166567325592,0.9913086891174316,0.9923005104064941,10000,add,ngram,1
Fertility,0.5199999809265137,0.10289525985717773,0.1390085220336914,10000,add,ngram,1
Flags,0.1875,0.2395484447479248,0.12144684791564941,10000,add,ngram,1
Glass,0.3207547068595886,0.28215479850769043,0.21171784400939941,10000,add,ngram,1
HabermanSurvival,0.6842105388641357,0.3628346920013428,0.41538500785827637,10000,add,ngram,1
HayesRoth,0.5,0.15051746368408203,0.1537928581237793,10000,add,ngram,1
HeartCleveland,0.5394737124443054,0.3950989246368408,0.40343165397644043,10000,add,ngram,1
HeartHungarian,0.698630154132843,0.22943329811096191,0.4021737575531006,10000,add,ngram,1
HeartSwitzerland,0.22580644488334656,0.14605236053466797,0.12913107872009277,10000,add,ngram,1
HeartVa,0.20000000298023224,0.23708057403564453,0.13962030410766602,10000,add,ngram,1
Hepatitis,0.5128205418586731,0.1811847686767578,0.21542668342590332,10000,add,ngram,1
HillValley,0.5066006779670715,1.021914005279541,2.7611615657806396,10000,add,ngram,1
HorseColic,0.4117647111415863,0.44939756393432617,0.371232271194458,10000,add,ngram,1
IlpdIndianLiver,0.2876712381839752,0.663036584854126,0.8035078048706055,10000,add,ngram,1
ImageSegmentation,0.1428571492433548,0.3016242980957031,9.963311672210693,10000,add,ngram,1
Ionosphere,0.7045454382896423,0.48366713523864746,0.41414833068847656,10000,add,ngram,1
Iris,0.4054054021835327,0.1457219123840332,0.2043166160583496,10000,add,ngram,1
LedDisplay,0.3720000088214874,0.8683254718780518,1.336491346359253,10000,add,ngram,1
Lenses,0.5,0.02557969093322754,0.02405524253845215,10000,add,ngram,1
Letter,0.039400000125169754,16.328351497650146,15.062294244766235,10000,add,ngram,1
Libras,0.06666667014360428,0.4194309711456299,0.1818861961364746,10000,add,ngram,1
LowResSpect,0.1654135286808014,0.6799683570861816,0.3228120803833008,10000,add,ngram,1
LungCancer,0.25,0.02306842803955078,0.023946285247802734,10000,add,ngram,1
Lymphography,0.4324324429035187,0.13831281661987305,0.20373964309692383,10000,add,ngram,1
Magic,0.6483701467514038,20.447471380233765,17.122859001159668,10000,add,ngram,1
Mammographic,0.7708333134651184,0.8812944889068604,0.8374178409576416,10000,add,ngram,1
Miniboone,0.28060030937194824,101.81287860870361,99.3740119934082,10000,add,ngram,1
MolecBiolPromoter,0.3461538553237915,0.0511627197265625,0.046326398849487305,10000,add,ngram,1
MolecBiolSplice,0.278544545173645,2.461846113204956,1.9120604991912842,10000,add,ngram,1
Monks1,0.5694444179534912,0.16729974746704102,1.1503891944885254,10000,add,ngram,1
Monks2,0.5416666865348816,0.17442631721496582,1.4849998950958252,10000,add,ngram,1
Monks3,0.7777777910232544,0.17217063903808594,1.143789291381836,10000,add,ngram,1
Mushroom,0.6582964062690735,6.474677085876465,6.00573992729187,10000,add,ngram,1
Musk1,0.5714285969734192,0.34229350090026855,0.20269036293029785,10000,add,ngram,1
Musk2,0.8459672331809998,5.768280744552612,5.313643455505371,10000,add,ngram,1
Nursery,0.38950616121292114,10.925907850265503,10.049852132797241,10000,add,ngram,1
OocytesMerlucciusNucleus4d,0.6705882549285889,0.97933030128479,0.8524200916290283,10000,add,ngram,1
OocytesMerlucciusStates2f,0.250980406999588,1.0992252826690674,0.6649680137634277,10000,add,ngram,1
OocytesTrisopterusNucleus2f,0.42105263471603394,0.4942455291748047,0.7243881225585938,10000,add,ngram,1
OocytesTrisopterusStates5b,0.5789473652839661,1.0363025665283203,0.5658791065216064,10000,add,ngram,1
Optical,0.09961046278476715,4.137485504150391,5.267691135406494,10000,add,ngram,1
Ozone,0.9716088175773621,2.414616346359253,1.7110795974731445,10000,add,ngram,1
PageBlocks,0.01608187146484852,4.551318645477295,4.010403871536255,10000,add,ngram,1
Parkinsons,0.26530611515045166,0.20513463020324707,0.27126049995422363,10000,add,ngram,1
Pendigits,0.1063464805483818,7.608459711074829,10.479808330535889,10000,add,ngram,1
Pima,0.6666666865348816,0.5239408016204834,0.8381226062774658,10000,add,ngram,1
PittsburgBridgesMaterial,0.6153846383094788,0.1226968765258789,0.14430832862854004,10000,add,ngram,1
PittsburgBridgesRelL,0.6153846383094788,0.11063718795776367,0.14441299438476562,10000,add,ngram,1
PittsburgBridgesSpan,0.47826087474823,0.08736968040466309,0.12515974044799805,10000,add,ngram,1
PittsburgBridgesTOrD,0.6800000071525574,0.11322283744812012,0.05396556854248047,10000,add,ngram,1
PittsburgBridgesType,0.3461538553237915,0.10361051559448242,0.14414262771606445,10000,add,ngram,1
Planning,0.7111111283302307,0.23693156242370605,0.24741053581237793,10000,add,ngram,1
PlantMargin,0.009999999776482582,1.177842617034912,1.096243143081665,10000,add,ngram,1
PlantShape,0.009999999776482582,1.3001439571380615,1.3978984355926514,10000,add,ngram,1
PlantTexture,0.009999999776482582,1.3231847286224365,2.056213617324829,10000,add,ngram,1
PostOperative,0.40909090638160706,0.05513787269592285,0.046630859375,10000,add,ngram,1
PrimaryTumor,0.04878048598766327,0.3437924385070801,0.24686241149902344,10000,add,ngram,1
Ringnorm,0.4951351284980774,5.863937854766846,5.567796468734741,10000,add,ngram,1
Seeds,0.36538460850715637,0.2253267765045166,0.21354413032531738,10000,add,ngram,1
Semeion,0.11809045076370239,1.740386724472046,1.361496925354004,10000,add,ngram,1
Soybean,0.050531916320323944,0.4981198310852051,1.172123908996582,10000,add,ngram,1
Spambase,0.6060869693756104,4.103785276412964,3.7249114513397217,10000,add,ngram,1
Spect,0.5483871102333069,0.08177638053894043,0.29724979400634766,10000,add,ngram,1
Spectf,0.08021390438079834,0.12421274185180664,0.6962287425994873,10000,add,ngram,1
StatlogAustralianCredit,0.36627906560897827,0.8545982837677002,0.27124953269958496,10000,add,ngram,1
StatlogGermanCredit,0.5799999833106995,0.9013528823852539,0.8514389991760254,10000,add,ngram,1
StatlogHeart,0.7611940503120422,0.2857038974761963,0.3612489700317383,10000,add,ngram,1
StatlogImage,0.1473136842250824,1.8837311267852783,1.6336565017700195,10000,add,ngram,1
StatlogLandsat,0.2304999977350235,4.741734266281128,6.03657078742981,10000,add,ngram,1
StatlogShuttle,0.0008965517044998705,66.4574191570282,55.951152086257935,10000,add,ngram,1
StatlogVehicle,0.2606635093688965,1.0682897567749023,1.0532684326171875,10000,add,ngram,1
SteelPlates,0.0804123729467392,1.591200828552246,1.678600788116455,10000,add,ngram,1
SyntheticControl,0.1666666716337204,0.7917270660400391,0.3538386821746826,10000,add,ngram,1
Teaching,0.5526315569877625,0.1383521556854248,0.20684218406677246,10000,add,ngram,1
Thyroid,0.021295215934515,3.6756792068481445,10.288607835769653,10000,add,ngram,1
TicTacToe,0.589958131313324,0.9351496696472168,0.7026326656341553,10000,add,ngram,1
Titanic,0.7709090709686279,1.8544881343841553,1.4778685569763184,10000,add,ngram,1
Trains,0.5,0.011229991912841797,0.008855342864990234,10000,add,ngram,1
Twonorm,0.500540554523468,6.018415927886963,5.362106084823608,10000,add,ngram,1
VertebralColumn2Clases,0.3246753215789795,0.4041616916656494,0.42147374153137207,10000,add,ngram,1
VertebralColumn3Clases,0.2467532455921173,0.29048728942871094,0.41701698303222656,10000,add,ngram,1
WallFollowing,0.151759535074234,4.259488821029663,4.008766412734985,10000,add,ngram,1
Waveform,0.3312000036239624,4.030938148498535,3.5852320194244385,10000,add,ngram,1
WaveformNoise,0.3391999900341034,4.205819606781006,3.3915698528289795,10000,add,ngram,1
Wine,0.3181818127632141,0.21555423736572266,0.2392425537109375,10000,add,ngram,1
WineQualityRed,0.004999999888241291,1.289811611175537,1.311990737915039,10000,add,ngram,1
WineQualityWhite,0.004084967542439699,3.918944835662842,3.917754888534546,10000,add,ngram,1
Yeast,0.032345011830329895,1.101210117340088,1.138814926147461,10000,add,ngram,1
Zoo,0.8799999952316284,0.09643220901489258,0.13853240013122559,10000,add,ngram,1
Abalone,0.5929118990898132,3.196490526199341,2.8116822242736816,10000,add,hashmap,1
AcuteInflammation,1.0,0.10617899894714355,0.15888428688049316,10000,add,hashmap,1
AcuteNephritis,1.0,0.13559913635253906,0.16118073463439941,10000,add,hashmap,1
Adult,0.7045636177062988,32.20639252662659,48.37484931945801,10000,add,hashmap,1
Annealing,0.6299999952316284,0.6924130916595459,0.3137495517730713,10000,add,hashmap,1
Arrhythmia,0.36283186078071594,0.3209545612335205,0.19034624099731445,10000,add,hashmap,1
AudiologyStd,0.9200000166893005,0.1343369483947754,0.13695073127746582,10000,add,hashmap,1
BalanceScale,0.7948718070983887,0.5148022174835205,0.6636059284210205,10000,add,hashmap,1
Balloons,1.0,0.009551763534545898,0.008867025375366211,10000,add,hashmap,1
Bank,0.6513274312019348,3.1771907806396484,3.261342763900757,10000,add,hashmap,1
Blood,0.5614973306655884,0.75445556640625,0.2896244525909424,10000,add,hashmap,1
BreastCancer,0.7183098793029785,0.3271009922027588,0.3089935779571533,10000,add,hashmap,1
BreastCancerWisc,0.9599999785423279,0.6954202651977539,0.44373369216918945,10000,add,hashmap,1
BreastCancerWiscDiag,0.9295774698257446,0.6838209629058838,0.2752993106842041,10000,add,hashmap,1
BreastCancerWiscProg,0.5306122303009033,0.19049644470214844,0.26174235343933105,10000,add,hashmap,1
BreastTissue,0.7307692170143127,0.07360720634460449,0.1165781021118164,10000,add,hashmap,1
Car,0.7847222089767456,1.5243401527404785,1.3395841121673584,10000,add,hashmap,1
Cardiotocography10Clases,0.6007533073425293,1.3416378498077393,1.5710315704345703,10000,add,hashmap,1
Cardiotocography3Clases,0.7608286142349243,1.3502092361450195,1.4972584247589111,10000,add,hashmap,1
ChessKrvk,0.27331051230430603,19.35517978668213,20.676558017730713,10000,add,hashmap,1
ChessKrvkp,0.8397997617721558,2.332002639770508,2.454620361328125,10000,add,hashmap,1
CongressionalVoting,0.5229358077049255,0.3075997829437256,0.1703052520751953,10000,add,hashmap,1
ConnBenchSonarMinesRocks,0.7115384340286255,0.21395373344421387,0.28057360649108887,10000,add,hashmap,1
ConnBenchVowelDeterding,0.8376623392105103,0.3632526397705078,1.1753156185150146,10000,add,hashmap,1
Connect4,0.67197585105896,52.9157612323761,51.0332133769989,10000,add,hashmap,1
Contrac,0.49728259444236755,1.2156479358673096,1.1595749855041504,10000,add,hashmap,1
CreditApproval,0.8488371968269348,0.6255903244018555,0.2662808895111084,10000,add,hashmap,1
CylinderBands,0.6953125,0.601348876953125,0.19867897033691406,10000,add,hashmap,1
Dermatology,0.9780219793319702,0.40674686431884766,0.37265443801879883,10000,add,hashmap,1
Echocardiogram,0.8787878751754761,0.08601021766662598,0.1756269931793213,10000,add,hashmap,1
Ecoli,0.8809523582458496,0.36092281341552734,0.31946587562561035,10000,add,hashmap,1
EnergyY1,0.8333333134651184,0.922290563583374,0.3004145622253418,10000,add,hashmap,1
EnergyY2,0.859375,0.7653520107269287,0.35367751121520996,10000,add,hashmap,1
Fertility,0.7200000286102295,0.08048582077026367,0.13567304611206055,10000,add,hashmap,1
Flags,0.4375,0.12730622291564941,0.14527392387390137,10000,add,hashmap,1
Glass,0.5283018946647644,0.14449238777160645,0.2846081256866455,10000,add,hashmap,1
HabermanSurvival,0.6052631735801697,0.3413841724395752,0.22657346725463867,10000,add,hashmap,1
HayesRoth,0.6071428656578064,0.15695405006408691,0.15171408653259277,10000,add,hashmap,1
HeartCleveland,0.5657894611358643,0.2813987731933594,0.30712103843688965,10000,add,hashmap,1
HeartHungarian,0.8219178318977356,0.2632741928100586,0.38996005058288574,10000,add,hashmap,1
HeartSwitzerland,0.3870967626571655,0.08172821998596191,0.12149357795715332,10000,add,hashmap,1
HeartVa,0.2199999988079071,0.08593440055847168,0.25478601455688477,10000,add,hashmap,1
Hepatitis,0.8717948794364929,0.2050795555114746,0.21127772331237793,10000,add,hashmap,1
HillValley,0.5099009871482849,0.41997671127319336,1.8878018856048584,10000,add,hashmap,1
HorseColic,0.7941176295280457,0.44105052947998047,0.3503544330596924,10000,add,hashmap,1
IlpdIndianLiver,0.6575342416763306,0.7028720378875732,0.624197244644165,10000,add,hashmap,1
ImageSegmentation,0.8538095355033875,0.33174967765808105,6.406857490539551,10000,add,hashmap,1
Ionosphere,0.7954545617103577,0.3890233039855957,0.43645405769348145,10000,add,hashmap,1
Iris,0.9729729890823364,0.18364286422729492,0.20014572143554688,10000,add,hashmap,1
LedDisplay,0.7599999904632568,0.7009637355804443,0.8319659233093262,10000,add,hashmap,1
Lenses,1.0,0.01586294174194336,0.015030384063720703,10000,add,hashmap,1
Letter,0.6732000112533569,15.418009519577026,13.329308271408081,10000,add,hashmap,1
Libras,0.5777778029441833,0.37777161598205566,0.48070788383483887,10000,add,hashmap,1
LowResSpect,0.7669172883033752,0.5230586528778076,0.5803635120391846,10000,add,hashmap,1
LungCancer,0.25,0.01694655418395996,0.01640605926513672,10000,add,hashmap,1
Lymphography,0.9189189076423645,0.11503958702087402,0.19189763069152832,10000,add,hashmap,1
Magic,0.7777076959609985,20.165504693984985,20.057164669036865,10000,add,hashmap,1
Mammographic,0.7833333611488342,1.1139740943908691,0.9999833106994629,10000,add,hashmap,1
Miniboone,0.28444457054138184,96.99504899978638,126.37333846092224,10000,add,hashmap,1
MolecBiolPromoter,0.9230769276618958,0.06066775321960449,0.14037871360778809,10000,add,hashmap,1
MolecBiolSplice,0.8594730496406555,3.579564332962036,2.902176856994629,10000,add,hashmap,1
Monks1,0.6550925970077515,0.15087437629699707,1.9578700065612793,10000,add,hashmap,1
Monks2,0.8425925970077515,0.18761396408081055,1.6322410106658936,10000,add,hashmap,1
Monks3,0.9050925970077515,0.16612648963928223,1.7177224159240723,10000,add,hashmap,1
Mushroom,0.8862629532814026,9.56637716293335,8.590819120407104,10000,add,hashmap,1
Musk1,0.5966386795043945,0.5022611618041992,0.6322653293609619,10000,add,hashmap,1
Musk2,0.7519708871841431,7.387124061584473,7.017461538314819,10000,add,hashmap,1
Nursery,0.8626543283462524,14.02615475654602,11.106930494308472,10000,add,hashmap,1
OocytesMerlucciusNucleus4d,0.6039215922355652,1.1216390132904053,0.8428981304168701,10000,add,hashmap,1
OocytesMerlucciusStates2f,0.8352941274642944,1.006706953048706,0.9243021011352539,10000,add,hashmap,1
OocytesTrisopterusNucleus2f,0.5570175647735596,0.8897919654846191,0.5280022621154785,10000,add,hashmap,1
OocytesTrisopterusStates5b,0.6842105388641357,0.5504140853881836,0.7892355918884277,10000,add,hashmap,1
Optical,0.8948246836662292,3.8441715240478516,5.03690505027771,10000,add,hashmap,1
Ozone,0.7444794774055481,2.2823879718780518,1.8525047302246094,10000,add,hashmap,1
PageBlocks,0.7258771657943726,4.519175052642822,3.5614142417907715,10000,add,hashmap,1
Parkinsons,0.8571428656578064,0.2124466896057129,0.2648329734802246,10000,add,hashmap,1
Pendigits,0.8093196153640747,7.457014799118042,9.98430061340332,10000,add,hashmap,1
Pima,0.65625,0.7263484001159668,0.9087309837341309,10000,add,hashmap,1
PittsburgBridgesMaterial,0.8461538553237915,0.09182596206665039,0.13961052894592285,10000,add,hashmap,1
PittsburgBridgesRelL,0.6153846383094788,0.08976984024047852,0.13997745513916016,10000,add,hashmap,1
PittsburgBridgesSpan,0.739130437374115,0.10900735855102539,0.12531781196594238,10000,add,hashmap,1
PittsburgBridgesTOrD,0.7599999904632568,0.10593533515930176,0.05713677406311035,10000,add,hashmap,1
PittsburgBridgesType,0.6153846383094788,0.09422183036804199,0.14083504676818848,10000,add,hashmap,1
Planning,0.5111111402511597,0.18704700469970703,0.24202561378479004,10000,add,hashmap,1
PlantMargin,0.7599999904632568,1.1013965606689453,1.073850154876709,10000,add,hashmap,1
PlantShape,0.33500000834465027,1.1750922203063965,1.058361530303955,10000,add,hashmap,1
PlantTexture,0.7200000286102295,1.6108357906341553,1.095902919769287,10000,add,hashmap,1
PostOperative,0.5454545617103577,0.08103322982788086,0.11254644393920898,10000,add,hashmap,1
PrimaryTumor,0.4390243887901306,0.4352757930755615,0.15186595916748047,10000,add,hashmap,1
Ringnorm,0.9524324536323547,5.416465520858765,4.614701747894287,10000,add,hashmap,1
Seeds,0.8653846383094788,0.23155593872070312,0.2749011516571045,10000,add,hashmap,1
Semeion,0.8341708779335022,1.402726411819458,1.3880908489227295,10000,add,hashmap,1
Soybean,0.853723406791687,0.3338198661804199,1.0456044673919678,10000,add,hashmap,1
Spambase,0.8278260827064514,3.196673631668091,5.487133264541626,10000,add,hashmap,1
Spect,0.5913978219032288,0.06330442428588867,0.9226374626159668,10000,add,hashmap,1
Spectf,0.4010695219039917,0.08635640144348145,0.9579434394836426,10000,add,hashmap,1
StatlogAustralianCredit,0.5465116500854492,0.8407585620880127,0.7368423938751221,10000,add,hashmap,1
StatlogGermanCredit,0.6919999718666077,1.2406845092773438,1.2691102027893066,10000,add,hashmap,1
StatlogHeart,0.8805969953536987,0.2880713939666748,0.35454225540161133,10000,add,hashmap,1
StatlogImage,0.8786828517913818,2.6363861560821533,2.504110097885132,10000,add,hashmap,1
StatlogLandsat,0.7860000133514404,5.186755180358887,5.313767671585083,10000,add,hashmap,1
StatlogShuttle,0.05779310315847397,41.539456605911255,53.70551896095276,10000,add,hashmap,1
StatlogVehicle,0.5402843356132507,0.8927798271179199,0.329348087310791,10000,add,hashmap,1
SteelPlates,0.5484536290168762,1.600559949874878,1.1908016204833984,10000,add,hashmap,1
SyntheticControl,0.9133333563804626,0.6870145797729492,0.4267702102661133,10000,add,hashmap,1
Teaching,0.5526315569877625,0.07818603515625,0.15251898765563965,10000,add,hashmap,1
Thyroid,0.5102100372314453,3.4257404804229736,9.47992467880249,10000,add,hashmap,1
TicTacToe,0.6736401915550232,0.6180918216705322,0.8020529747009277,10000,add,hashmap,1
Titanic,0.7872727513313293,2.0274062156677246,1.3127763271331787,10000,add,hashmap,1
Trains,0.5,0.00932765007019043,0.006817817687988281,10000,add,hashmap,1
Twonorm,0.9691891670227051,5.44263482093811,5.1376800537109375,10000,add,hashmap,1
VertebralColumn2Clases,0.7662337422370911,0.36217308044433594,0.4108901023864746,10000,add,hashmap,1
VertebralColumn3Clases,0.5324675440788269,0.37439465522766113,0.41423988342285156,10000,add,hashmap,1
WallFollowing,0.6480938196182251,4.1758599281311035,3.9934589862823486,10000,add,hashmap,1
Waveform,0.8151999711990356,3.8045103549957275,3.7659571170806885,10000,add,hashmap,1
WaveformNoise,0.7832000255584717,3.315000295639038,4.065982341766357,10000,add,hashmap,1
Wine,0.9545454382896423,0.10422396659851074,0.23741531372070312,10000,add,hashmap,1
WineQualityRed,0.32499998807907104,1.0163555145263672,1.1809494495391846,10000,add,hashmap,1
WineQualityWhite,0.28513070940971375,4.3076276779174805,5.355052709579468,10000,add,hashmap,1
Yeast,0.5336927175521851,1.420973300933838,0.9256143569946289,10000,add,hashmap,1
Zoo,0.9599999785423279,0.05799078941345215,0.130265474319458,10000,add,hashmap,1
Abalone,0.5938697457313538,2.9527792930603027,3.3962152004241943,10000,add,flocet,1
AcuteInflammation,1.0,0.04943680763244629,0.14005041122436523,10000,add,flocet,1
AcuteNephritis,1.0,0.16260027885437012,0.16314411163330078,10000,add,flocet,1
Adult,0.7077575325965881,31.8542263507843,47.23998141288757,10000,add,flocet,1
Annealing,0.4699999988079071,0.6709718704223633,0.23214077949523926,10000,add,flocet,1
Arrhythmia,0.38053098320961,0.3230135440826416,0.3655858039855957,10000,add,flocet,1
AudiologyStd,0.8399999737739563,0.13209867477416992,0.1366889476776123,10000,add,flocet,1
BalanceScale,0.7884615659713745,0.8264403343200684,0.26500654220581055,10000,add,flocet,1
Balloons,1.0,0.023861169815063477,0.023772239685058594,10000,add,flocet,1
Bank,0.6495575308799744,3.3049590587615967,3.650132894515991,10000,add,flocet,1
Blood,0.5775400996208191,0.8437819480895996,0.29245924949645996,10000,add,flocet,1
BreastCancer,0.7183098793029785,0.27705883979797363,0.11161565780639648,10000,add,flocet,1
BreastCancerWisc,0.9599999785423279,0.7311065196990967,0.2732515335083008,10000,add,flocet,1
BreastCancerWiscDiag,0.9295774698257446,0.3276669979095459,0.2749812602996826,10000,add,flocet,1
BreastCancerWiscProg,0.5510203838348389,0.2274625301361084,0.14225506782531738,10000,add,flocet,1
BreastTissue,0.7692307829856873,0.04584455490112305,0.13743066787719727,10000,add,flocet,1
Car,0.7430555820465088,1.4501683712005615,1.1057207584381104,10000,add,flocet,1
Cardiotocography10Clases,0.6026365160942078,1.6997032165527344,1.2606287002563477,10000,add,flocet,1
Cardiotocography3Clases,0.7608286142349243,1.360381841659546,1.782641887664795,10000,add,flocet,1
ChessKrvk,0.27331051230430603,20.090903759002686,21.645931243896484,10000,add,flocet,1
ChessKrvkp,0.8360450267791748,2.735166072845459,2.0712225437164307,10000,add,flocet,1
CongressionalVoting,0.5321100950241089,0.5464890003204346,0.2997095584869385,10000,add,flocet,1
ConnBenchSonarMinesRocks,0.7307692170143127,0.12191891670227051,0.28522515296936035,10000,add,flocet,1
ConnBenchVowelDeterding,0.8290043473243713,0.5125105381011963,1.5423967838287354,10000,add,flocet,1
Connect4,0.672390341758728,55.89213013648987,76.15752172470093,10000,add,flocet,1
Contrac,0.47826087474823,1.4616897106170654,1.0055582523345947,10000,add,flocet,1
CreditApproval,0.8372092843055725,0.7413761615753174,0.2691986560821533,10000,add,flocet,1
CylinderBands,0.7109375,0.35631775856018066,0.20084857940673828,10000,add,flocet,1
Dermatology,0.9780219793319702,0.2682304382324219,0.1431562900543213,10000,add,flocet,1
Echocardiogram,0.8787878751754761,0.1788012981414795,0.1761324405670166,10000,add,flocet,1
Ecoli,0.8809523582458496,0.35628676414489746,0.45388364791870117,10000,add,flocet,1
EnergyY1,0.8385416865348816,0.9520082473754883,0.3952767848968506,10000,add,flocet,1
EnergyY2,0.859375,0.6096365451812744,0.5142707824707031,10000,add,flocet,1
Fertility,0.7200000286102295,0.08799934387207031,0.04262971878051758,10000,add,flocet,1
Flags,0.4375,0.15978598594665527,0.2657783031463623,10000,add,flocet,1
Glass,0.5660377144813538,0.08935976028442383,0.08808207511901855,10000,add,flocet,1
HabermanSurvival,0.6052631735801697,0.34779834747314453,0.3916153907775879,10000,add,flocet,1
HayesRoth,0.7142857313156128,0.07217884063720703,0.09041357040405273,10000,add,flocet,1
HeartCleveland,0.5526315569877625,0.19003534317016602,0.11968541145324707,10000,add,flocet,1
HeartHungarian,0.8082191944122314,0.34044766426086426,0.30741071701049805,10000,add,flocet,1
HeartSwitzerland,0.4193548262119293,0.05230450630187988,0.059632062911987305,10000,add,flocet,1
HeartVa,0.20000000298023224,0.19765830039978027,0.09445524215698242,10000,add,flocet,1
Hepatitis,0.8717948794364929,0.16194772720336914,0.2124617099761963,10000,add,flocet,1
HillValley,0.5082508325576782,0.3725614547729492,1.878465175628662,10000,add,flocet,1
HorseColic,0.7647058963775635,0.5558021068572998,0.14658021926879883,10000,add,flocet,1
IlpdIndianLiver,0.6506849527359009,0.752497673034668,0.23069310188293457,10000,add,flocet,1
ImageSegmentation,0.8566666841506958,0.38903307914733887,5.498401880264282,10000,add,flocet,1
Ionosphere,0.8409090638160706,0.4735875129699707,0.4802718162536621,10000,add,flocet,1
Iris,0.9729729890823364,0.1887214183807373,0.20154833793640137,10000,add,flocet,1
LedDisplay,0.7720000147819519,0.5993316173553467,0.8405454158782959,10000,add,flocet,1
Lenses,1.0,0.01365518569946289,0.013211965560913086,10000,add,flocet,1
Letter,0.66839998960495,15.4648916721344,14.510219097137451,10000,add,flocet,1
Libras,0.5888888835906982,0.3147697448730469,0.4875295162200928,10000,add,flocet,1
LowResSpect,0.7669172883033752,0.6401050090789795,0.4760143756866455,10000,add,flocet,1
LungCancer,0.375,0.014001131057739258,0.01332855224609375,10000,add,flocet,1
Lymphography,0.837837815284729,0.06653618812561035,0.1688532829284668,10000,add,flocet,1
Magic,0.772870659828186,13.788247346878052,14.160269498825073,10000,add,flocet,1
Mammographic,0.7958333492279053,0.7583823204040527,0.7984025478363037,10000,add,flocet,1
Miniboone,0.28444457054138184,111.41582918167114,119.16014623641968,10000,add,flocet,1
MolecBiolPromoter,0.8846153616905212,0.14697861671447754,0.12965679168701172,10000,add,flocet,1
MolecBiolSplice,0.779171884059906,3.6458041667938232,3.90637469291687,10000,add,flocet,1
Monks1,0.6689814925193787,0.1727886199951172,1.9834418296813965,10000,add,flocet,1
Monks2,0.8495370149612427,0.30464887619018555,1.975362777709961,10000,add,flocet,1
Monks3,0.8958333134651184,0.06678652763366699,1.0917255878448486,10000,add,flocet,1
Mushroom,0.8847858309745789,6.144785642623901,5.448588132858276,10000,add,flocet,1
Musk1,0.5882353186607361,0.5595591068267822,0.19068193435668945,10000,add,flocet,1
Musk2,0.755003035068512,5.127938270568848,5.03394627571106,10000,add,flocet,1
Nursery,0.8395061492919922,13.635760068893433,13.65602159500122,10000,add,flocet,1
OocytesMerlucciusNucleus4d,0.6196078658103943,0.4922456741333008,0.6343841552734375,10000,add,flocet,1
OocytesMerlucciusStates2f,0.8313725590705872,0.6415231227874756,1.0014994144439697,10000,add,flocet,1
OocytesTrisopterusNucleus2f,0.5614035129547119,0.913320779800415,0.5675520896911621,10000,add,flocet,1
OocytesTrisopterusStates5b,0.7017543911933899,0.791400671005249,0.5621113777160645,10000,add,flocet,1
Optical,0.8964941501617432,3.913320779800415,6.429232597351074,10000,add,flocet,1
Ozone,0.7318611741065979,2.491990089416504,3.023252248764038,10000,add,flocet,1
PageBlocks,0.722953200340271,4.285925388336182,4.580138444900513,10000,add,flocet,1
Parkinsons,0.8571428656578064,0.26764464378356934,0.2664656639099121,10000,add,flocet,1
Pendigits,0.8058890700340271,8.025780439376831,9.357614278793335,10000,add,flocet,1
Pima,0.6822916865348816,0.466571569442749,0.6406707763671875,10000,add,flocet,1
PittsburgBridgesMaterial,0.8846153616905212,0.11449623107910156,0.13997936248779297,10000,add,flocet,1
PittsburgBridgesRelL,0.6153846383094788,0.14239788055419922,0.08543062210083008,10000,add,flocet,1
PittsburgBridgesSpan,0.739130437374115,0.1267528533935547,0.12648558616638184,10000,add,flocet,1
PittsburgBridgesTOrD,0.7200000286102295,0.1338491439819336,0.13761591911315918,10000,add,flocet,1
PittsburgBridgesType,0.6538461446762085,0.07480025291442871,0.1403188705444336,10000,add,flocet,1
Planning,0.4444444477558136,0.14263486862182617,0.07179474830627441,10000,add,flocet,1
PlantMargin,0.7599999904632568,1.664431095123291,1.0503079891204834,10000,add,flocet,1
PlantShape,0.3199999928474426,1.0924735069274902,1.115687370300293,10000,add,flocet,1
PlantTexture,0.7074999809265137,0.934272050857544,1.1656997203826904,10000,add,flocet,1
PostOperative,0.4545454680919647,0.06854820251464844,0.11949777603149414,10000,add,flocet,1
PrimaryTumor,0.4268292784690857,0.32396793365478516,0.2216968536376953,10000,add,flocet,1
Ringnorm,0.9448648691177368,4.781743049621582,5.078780889511108,10000,add,flocet,1
Seeds,0.8653846383094788,0.28920674324035645,0.19362187385559082,10000,add,flocet,1
Semeion,0.839195966720581,1.810821294784546,1.4935238361358643,10000,add,flocet,1
Soybean,0.8590425252914429,0.34253954887390137,1.3585572242736816,10000,add,flocet,1
Spambase,0.8139130473136902,3.784867286682129,5.273244380950928,10000,add,flocet,1
Spect,0.698924720287323,0.08069658279418945,0.8201675415039062,10000,add,flocet,1
Spectf,0.3850267231464386,0.14745616912841797,0.6046833992004395,10000,add,flocet,1
StatlogAustralianCredit,0.5348837375640869,0.8352193832397461,0.8965258598327637,10000,add,flocet,1
StatlogGermanCredit,0.6919999718666077,1.2352426052093506,1.2672271728515625,10000,add,flocet,1
StatlogHeart,0.8805969953536987,0.1725752353668213,0.33664417266845703,10000,add,flocet,1
StatlogImage,0.8700173497200012,2.4523301124572754,2.3167335987091064,10000,add,flocet,1
StatlogLandsat,0.7820000052452087,5.970070123672485,9.6770498752594,10000,add,flocet,1
StatlogShuttle,0.05986206978559494,61.67207074165344,52.137736558914185,10000,add,flocet,1
StatlogVehicle,0.549763023853302,0.848588228225708,0.6753721237182617,10000,add,flocet,1
SteelPlates,0.5340206027030945,1.50105619430542,2.0701963901519775,10000,add,flocet,1
SyntheticControl,0.9200000166893005,0.43512654304504395,0.3329331874847412,10000,add,flocet,1
Teaching,0.5526315569877625,0.15192008018493652,0.11211371421813965,10000,add,flocet,1
Thyroid,0.49679112434387207,3.9365200996398926,14.049421310424805,10000,add,flocet,1
TicTacToe,0.6485355496406555,0.42482733726501465,0.7872452735900879,10000,add,flocet,1
Titanic,0.7818182110786438,1.7409493923187256,1.3269093036651611,10000,add,flocet,1
Trains,0.5,0.016504764556884766,0.012929201126098633,10000,add,flocet,1
Twonorm,0.9691891670227051,8.157084941864014,7.398017644882202,10000,add,flocet,1
VertebralColumn2Clases,0.7662337422370911,0.14904308319091797,0.12076807022094727,10000,add,flocet,1
VertebralColumn3Clases,0.5064935088157654,0.42336416244506836,0.3391132354736328,10000,add,flocet,1
WallFollowing,0.6253665685653687,3.4900293350219727,3.637118339538574,10000,add,flocet,1
Waveform,0.8191999793052673,5.37703013420105,5.757638216018677,10000,add,flocet,1
WaveformNoise,0.7703999876976013,3.907140016555786,3.6003501415252686,10000,add,flocet,1
Wine,0.9545454382896423,0.08882999420166016,0.06972980499267578,10000,add,flocet,1
WineQualityRed,0.32249999046325684,1.0555157661437988,1.0648972988128662,10000,add,flocet,1
WineQualityWhite,0.3292483687400818,3.5125362873077393,2.956268787384033,10000,add,flocet,1
Yeast,0.5417789816856384,0.9736385345458984,0.997185230255127,10000,add,flocet,1
Zoo,0.9599999785423279,0.04866957664489746,0.056798696517944336,10000,add,flocet,1
Abalone,0.5967432856559753,3.1480157375335693,2.8532872200012207,10000,add,density,1
AcuteInflammation,1.0,0.16495060920715332,0.14554214477539062,10000,add,density,1
AcuteNephritis,1.0,0.16196417808532715,0.1641533374786377,10000,add,density,1
Adult,0.7064676880836487,24.82541799545288,44.0125846862793,10000,add,density,1
Annealing,0.46000000834465027,1.010077953338623,0.1573944091796875,10000,add,density,1
Arrhythmia,0.37168142199516296,0.5429027080535889,0.46599531173706055,10000,add,density,1
AudiologyStd,0.800000011920929,0.09676265716552734,0.08513188362121582,10000,add,density,1
BalanceScale,0.7884615659713745,0.8459999561309814,0.2692909240722656,10000,add,density,1
Balloons,1.0,0.024403810501098633,0.02375650405883789,10000,add,density,1
Bank,0.6539822816848755,2.906203269958496,3.0336132049560547,10000,add,density,1
Blood,0.5775400996208191,0.36745524406433105,0.6550195217132568,10000,add,density,1
BreastCancer,0.7183098793029785,0.38149023056030273,0.24023962020874023,10000,add,density,1
BreastCancerWisc,0.9599999785423279,0.6405017375946045,0.27443838119506836,10000,add,density,1
BreastCancerWiscDiag,0.9436619877815247,0.6923224925994873,0.22563886642456055,10000,add,density,1
BreastCancerWiscProg,0.5510203838348389,0.08977174758911133,0.07745742797851562,10000,add,density,1
BreastTissue,0.7692307829856873,0.04731321334838867,0.11321067810058594,10000,add,density,1
Car,0.7546296119689941,1.3127081394195557,1.3904085159301758,10000,add,density,1
Cardiotocography10Clases,0.598870038986206,1.736562728881836,1.8299047946929932,10000,add,density,1
Cardiotocography3Clases,0.7608286142349243,1.6711561679840088,1.2398672103881836,10000,add,density,1
ChessKrvk,0.272455096244812,20.15948486328125,18.79132628440857,10000,add,density,1
ChessKrvkp,0.831038773059845,2.3418774604797363,2.2072174549102783,10000,add,density,1
CongressionalVoting,0.5321100950241089,0.17586326599121094,0.1719069480895996,10000,add,density,1
ConnBenchSonarMinesRocks,0.692307710647583,0.2847559452056885,0.2834138870239258,10000,add,density,1
ConnBenchVowelDeterding,0.8160173296928406,0.8064327239990234,1.131056785583496,10000,add,density,1
Connect4,0.6744626760482788,60.183387756347656,48.747801065444946,10000,add,density,1
Contrac,0.4728260934352875,1.0020043849945068,0.6614432334899902,10000,add,density,1
CreditApproval,0.854651153087616,0.8167967796325684,0.716240406036377,10000,add,density,1
CylinderBands,0.71875,0.6886541843414307,0.25527381896972656,10000,add,density,1
Dermatology,0.9780219793319702,0.3351097106933594,0.16601324081420898,10000,add,density,1
Echocardiogram,0.8787878751754761,0.17998671531677246,0.17914342880249023,10000,add,density,1
Ecoli,0.8809523582458496,0.3050687313079834,0.13285446166992188,10000,add,density,1
EnergyY1,0.8489583134651184,0.6030392646789551,0.823056697845459,10000,add,density,1
EnergyY2,0.859375,0.6827116012573242,0.7706332206726074,10000,add,density,1
Fertility,0.7200000286102295,0.1365652084350586,0.13587117195129395,10000,add,density,1
Flags,0.4583333432674408,0.1902604103088379,0.2621784210205078,10000,add,density,1
Glass,0.5283018946647644,0.09155583381652832,0.23153471946716309,10000,add,density,1
HabermanSurvival,0.6052631735801697,0.27962446212768555,0.18226408958435059,10000,add,density,1
HayesRoth,0.7142857313156128,0.24119067192077637,0.10170388221740723,10000,add,density,1
HeartCleveland,0.5526315569877625,0.16306233406066895,0.39092111587524414,10000,add,density,1
HeartHungarian,0.8219178318977356,0.15050292015075684,0.22680354118347168,10000,add,density,1
HeartSwitzerland,0.4193548262119293,0.08482646942138672,0.1062774658203125,10000,add,density,1
HeartVa,0.25999999046325684,0.08310651779174805,0.20124173164367676,10000,add,density,1
Hepatitis,0.8717948794364929,0.21139049530029297,0.21251535415649414,10000,add,density,1
HillValley,0.5082508325576782,0.9323158264160156,1.7859289646148682,10000,add,density,1
HorseColic,0.779411792755127,0.5440382957458496,0.2258164882659912,10000,add,density,1
IlpdIndianLiver,0.6438356041908264,0.5918729305267334,0.22789525985717773,10000,add,density,1
ImageSegmentation,0.8580952286720276,0.29198336601257324,5.888917684555054,10000,add,density,1
Ionosphere,0.8295454382896423,0.15230417251586914,0.13881564140319824,10000,add,density,1
Iris,0.9729729890823364,0.06513714790344238,0.05872011184692383,10000,add,density,1
LedDisplay,0.7680000066757202,0.629249095916748,0.801292896270752,10000,add,density,1
Lenses,1.0,0.03428244590759277,0.03447294235229492,10000,add,density,1
Letter,0.6729999780654907,13.112834453582764,14.092111825942993,10000,add,density,1
Libras,0.6111111044883728,0.16977286338806152,0.14222192764282227,10000,add,density,1
LowResSpect,0.7744361162185669,0.23562097549438477,0.421004056930542,10000,add,density,1
LungCancer,0.375,0.04444313049316406,0.044835567474365234,10000,add,density,1
Lymphography,0.837837815284729,0.0624849796295166,0.17007946968078613,10000,add,density,1
Magic,0.774553120136261,13.735163450241089,13.160303354263306,10000,add,density,1
Mammographic,0.800000011920929,0.5820326805114746,0.6030442714691162,10000,add,density,1
Miniboone,0.28444457054138184,102.66628336906433,96.70861196517944,10000,add,density,1
MolecBiolPromoter,0.8846153616905212,0.06401562690734863,0.04188370704650879,10000,add,density,1
MolecBiolSplice,0.7992472052574158,1.8388397693634033,1.5252280235290527,10000,add,density,1
Monks1,0.6620370149612427,0.15165948867797852,1.021162509918213,10000,add,density,1
Monks2,0.8449074029922485,0.09223246574401855,0.8004233837127686,10000,add,density,1
Monks3,0.8912037014961243,0.11524415016174316,0.826024055480957,10000,add,density,1
Mushroom,0.8847858309745789,4.409008741378784,3.984844923019409,10000,add,density,1
Musk1,0.5798319578170776,0.4413716793060303,0.18978023529052734,10000,add,density,1
Musk2,0.7537901997566223,5.10245943069458,3.323535442352295,10000,add,density,1
Nursery,0.8444444537162781,9.865816593170166,10.010407209396362,10000,add,density,1
OocytesMerlucciusNucleus4d,0.6196078658103943,1.0983972549438477,0.4196135997772217,10000,add,density,1
OocytesMerlucciusStates2f,0.8352941274642944,1.382026195526123,1.3806605339050293,10000,add,density,1
OocytesTrisopterusNucleus2f,0.5526315569877625,1.2277719974517822,1.2243642807006836,10000,add,density,1
OocytesTrisopterusStates5b,0.6973684430122375,1.2360799312591553,0.890155553817749,10000,add,density,1
Optical,0.8981636166572571,5.818222999572754,6.105239391326904,10000,add,density,1
Ozone,0.7365930676460266,3.373296022415161,2.6251583099365234,10000,add,density,1
PageBlocks,0.7266082167625427,3.2921693325042725,3.9106364250183105,10000,add,density,1
Parkinsons,0.8367347121238708,0.11504578590393066,0.07768487930297852,10000,add,density,1
Pendigits,0.8013150095939636,6.063734769821167,12.759976625442505,10000,add,density,1
Pima,0.6822916865348816,1.0363729000091553,1.0386128425598145,10000,add,density,1
PittsburgBridgesMaterial,0.8461538553237915,0.14500975608825684,0.1405959129333496,10000,add,density,1
PittsburgBridgesRelL,0.6153846383094788,0.13905763626098633,0.15251398086547852,10000,add,density,1
PittsburgBridgesSpan,0.739130437374115,0.044913530349731445,0.05299806594848633,10000,add,density,1
PittsburgBridgesTOrD,0.7200000286102295,0.14296865463256836,0.13750338554382324,10000,add,density,1
PittsburgBridgesType,0.6538461446762085,0.056882619857788086,0.14237165451049805,10000,add,density,1
Planning,0.4888888895511627,0.2472515106201172,0.24167966842651367,10000,add,density,1
PlantMargin,0.7524999976158142,1.765486478805542,1.361975908279419,10000,add,density,1
PlantShape,0.32749998569488525,1.5679078102111816,0.6340279579162598,10000,add,density,1
PlantTexture,0.7099999785423279,1.068852424621582,0.6306638717651367,10000,add,density,1
PostOperative,0.4545454680919647,0.0469667911529541,0.035446882247924805,10000,add,density,1
PrimaryTumor,0.4146341383457184,0.34009504318237305,0.4383823871612549,10000,add,density,1
Ringnorm,0.9454054236412048,3.201491117477417,3.1483535766601562,10000,add,density,1
Seeds,0.8653846383094788,0.09102392196655273,0.08202433586120605,10000,add,density,1
Semeion,0.8366833925247192,0.9622757434844971,0.6548328399658203,10000,add,density,1
Soybean,0.8563829660415649,0.4793386459350586,0.669790506362915,10000,add,density,1
Spambase,0.8321738839149475,1.8460910320281982,1.7893545627593994,10000,add,density,1
Spect,0.6881720423698425,0.14377403259277344,1.000255823135376,10000,add,density,1
Spectf,0.3796791434288025,0.1430518627166748,0.3728468418121338,10000,add,density,1
StatlogAustralianCredit,0.5232558250427246,0.4390878677368164,0.2677276134490967,10000,add,density,1
StatlogGermanCredit,0.6880000233650208,1.2154271602630615,1.0699846744537354,10000,add,density,1
StatlogHeart,0.8656716346740723,0.36176013946533203,0.15146398544311523,10000,add,density,1
StatlogImage,0.8838821649551392,2.638467311859131,1.275747537612915,10000,add,density,1
StatlogLandsat,0.781499981880188,6.518860816955566,9.36819577217102,10000,add,density,1
StatlogShuttle,0.05779310315847397,54.66377925872803,45.37098455429077,10000,add,density,1
StatlogVehicle,0.549763023853302,0.8680260181427002,1.1340174674987793,10000,add,density,1
SteelPlates,0.5360824465751648,1.8263764381408691,0.8556785583496094,10000,add,density,1
SyntheticControl,0.9133333563804626,0.46024656295776367,0.5822336673736572,10000,add,density,1
Teaching,0.5526315569877625,0.20725154876708984,0.2049100399017334,10000,add,density,1
Thyroid,0.4909568130970001,3.128028392791748,6.258962154388428,10000,add,density,1
TicTacToe,0.6527196764945984,1.3015711307525635,0.811678409576416,10000,add,density,1
Titanic,0.7818182110786438,0.8836781978607178,0.9983642101287842,10000,add,density,1
Trains,0.5,0.016596555709838867,0.012865781784057617,10000,add,density,1
Twonorm,0.9686486721038818,4.073090076446533,3.5469722747802734,10000,add,density,1
VertebralColumn2Clases,0.7662337422370911,0.4171407222747803,0.42179036140441895,10000,add,density,1
VertebralColumn3Clases,0.4935064911842346,0.2963144779205322,0.12107515335083008,10000,add,density,1
WallFollowing,0.6224340200424194,2.847276449203491,3.4763121604919434,10000,add,density,1
Waveform,0.8199999928474426,3.4632461071014404,1.9761323928833008,10000,add,density,1
WaveformNoise,0.7847999930381775,4.218602180480957,2.3926522731781006,10000,add,density,1
Wine,0.9545454382896423,0.24390387535095215,0.23971104621887207,10000,add,density,1
WineQualityRed,0.33250001072883606,1.8817481994628906,2.1571547985076904,10000,add,density,1
WineQualityWhite,0.33169934153556824,5.781630516052246,2.8254737854003906,10000,add,density,1
Yeast,0.5471698045730591,1.9169254302978516,0.6564521789550781,10000,add,density,1
Zoo,0.9599999785423279,0.043552398681640625,0.1311359405517578,10000,add,density,1
Abalone,0.5316091775894165,2.0015146732330322,1.6840155124664307,10000,add,random,1
AcuteInflammation,1.0,0.04115629196166992,0.06545543670654297,10000,add,random,1
AcuteNephritis,0.9666666388511658,0.04406404495239258,0.11618447303771973,10000,add,random,1
Adult,0.6827590465545654,32.42900013923645,56.551363945007324,10000,add,random,1
Annealing,0.5299999713897705,0.5765268802642822,0.14062976837158203,10000,add,random,1
Arrhythmia,0.39823007583618164,0.30551743507385254,0.3650696277618408,10000,add,random,1
AudiologyStd,0.800000011920929,0.11121964454650879,0.12545394897460938,10000,add,random,1
BalanceScale,0.7307692170143127,0.3751974105834961,0.3542020320892334,10000,add,random,1
Balloons,0.75,0.008372306823730469,0.011414289474487305,10000,add,random,1
Bank,0.6079645752906799,2.3009817600250244,4.081130743026733,10000,add,random,1
Blood,0.5401069521903992,0.5119218826293945,0.4869053363800049,10000,add,random,1
BreastCancer,0.7323943376541138,0.1957857608795166,0.21790242195129395,10000,add,random,1
BreastCancerWisc,0.8914285898208618,0.5173239707946777,0.7540013790130615,10000,add,random,1
BreastCancerWiscDiag,0.8239436745643616,0.28663063049316406,0.45966672897338867,10000,add,random,1
BreastCancerWiscProg,0.5306122303009033,0.12288308143615723,0.23749518394470215,10000,add,random,1
BreastTissue,0.7307692170143127,0.05699443817138672,0.06559276580810547,10000,add,random,1
Car,0.5925925970077515,1.063655138015747,1.7973077297210693,10000,add,random,1
Cardiotocography10Clases,0.5932203531265259,0.939321756362915,2.1062283515930176,10000,add,random,1
Cardiotocography3Clases,0.7721280455589294,0.7979836463928223,1.796492338180542,10000,add,random,1
ChessKrvk,0.20430567860603333,19.582263469696045,27.920002698898315,10000,add,random,1
ChessKrvkp,0.8585731983184814,1.1638009548187256,2.340604543685913,10000,add,random,1
CongressionalVoting,0.5412843823432922,0.2794914245605469,0.5337364673614502,10000,add,random,1
ConnBenchSonarMinesRocks,0.6730769276618958,0.13648772239685059,0.25311779975891113,10000,add,random,1
ConnBenchVowelDeterding,0.8160173296928406,0.40573906898498535,0.960674524307251,10000,add,random,1
Connect4,0.5657528638839722,22.805264234542847,32.45672821998596,10000,add,random,1
Contrac,0.489130437374115,1.0730721950531006,1.7742538452148438,10000,add,random,1
CreditApproval,0.8313953280448914,0.593327522277832,0.8276114463806152,10000,add,random,1
CylinderBands,0.7109375,0.39091944694519043,0.61551833152771,10000,add,random,1
Dermatology,0.9780219793319702,0.2961845397949219,0.27288103103637695,10000,add,random,1
Echocardiogram,0.8787878751754761,0.06459331512451172,0.08312153816223145,10000,add,random,1
Ecoli,0.7023809552192688,0.2809321880340576,0.40788841247558594,10000,add,random,1
EnergyY1,0.8489583134651184,0.6365716457366943,0.9177968502044678,10000,add,random,1
EnergyY2,0.8385416865348816,0.6575126647949219,0.9236485958099365,10000,add,random,1
Fertility,0.6800000071525574,0.05747556686401367,0.09814810752868652,10000,add,random,1
Flags,0.4166666567325592,0.10847759246826172,0.23050546646118164,10000,add,random,1
Glass,0.5094339847564697,0.16330361366271973,0.25826001167297363,10000,add,random,1
HabermanSurvival,0.6315789222717285,0.18863868713378906,0.36816930770874023,10000,add,random,1
HayesRoth,0.4285714328289032,0.13300800323486328,0.1368553638458252,10000,add,random,1
HeartCleveland,0.5131579041481018,0.24016213417053223,0.36440491676330566,10000,add,random,1
HeartHungarian,0.7397260069847107,0.24608278274536133,0.3537325859069824,10000,add,random,1
HeartSwitzerland,0.3870967626571655,0.09395480155944824,0.15178656578063965,10000,add,random,1
HeartVa,0.23999999463558197,0.14757704734802246,0.24323487281799316,10000,add,random,1
Hepatitis,0.8205128312110901,0.10408449172973633,0.1863400936126709,10000,add,random,1
HillValley,0.6732673048973083,0.5305614471435547,1.0447828769683838,10000,add,random,1
HorseColic,0.7941176295280457,0.19434595108032227,0.09628534317016602,10000,add,random,1
IlpdIndianLiver,0.6575342416763306,0.40409135818481445,0.20426011085510254,10000,add,random,1
ImageSegmentation,0.8204761743545532,0.18329119682312012,3.7830846309661865,10000,add,random,1
Ionosphere,0.8409090638160706,0.225388765335083,0.32967352867126465,10000,add,random,1
Iris,0.7567567825317383,0.08879590034484863,0.1029195785522461,10000,add,random,1
LedDisplay,0.7559999823570251,0.8866598606109619,0.39360570907592773,10000,add,random,1
Lenses,0.8333333134651184,0.015094995498657227,0.020128488540649414,10000,add,random,1
Letter,0.6262000203132629,6.335415363311768,7.659479856491089,10000,add,random,1
Libras,0.5555555820465088,0.22718596458435059,0.12741374969482422,10000,add,random,1
LowResSpect,0.7819548845291138,0.4334554672241211,0.5528206825256348,10000,add,random,1
LungCancer,0.25,0.015222787857055664,0.018642187118530273,10000,add,random,1
Lymphography,0.8918918967247009,0.08294200897216797,0.17679953575134277,10000,add,random,1
Magic,0.7655099630355835,5.768422603607178,7.332433700561523,10000,add,random,1
Mammographic,0.7333333492279053,0.825129508972168,1.1578795909881592,10000,add,random,1
Miniboone,0.28444457054138184,65.5963499546051,75.77016282081604,10000,add,random,1
MolecBiolPromoter,0.8846153616905212,0.03785276412963867,0.08128786087036133,10000,add,random,1
MolecBiolSplice,0.7365119457244873,1.0102691650390625,1.1207118034362793,10000,add,random,1
Monks1,0.6504629850387573,0.06835174560546875,0.6290159225463867,10000,add,random,1
Monks2,0.5625,0.11565780639648438,1.34322190284729,10000,add,random,1
Monks3,0.7199074029922485,0.1254119873046875,1.490027666091919,10000,add,random,1
Mushroom,0.8729689717292786,3.491093873977661,3.3413147926330566,10000,add,random,1
Musk1,0.5882353186607361,0.26046252250671387,0.16770720481872559,10000,add,random,1
Musk2,0.7392358779907227,2.8917152881622314,2.929356336593628,10000,add,random,1
Nursery,0.7120370268821716,3.701887607574463,5.565536975860596,10000,add,random,1
OocytesMerlucciusNucleus4d,0.615686297416687,0.5245423316955566,0.35918092727661133,10000,add,random,1
OocytesMerlucciusStates2f,0.8509804010391235,0.8145489692687988,1.227041482925415,10000,add,random,1
OocytesTrisopterusNucleus2f,0.5350877046585083,0.7784914970397949,1.0494215488433838,10000,add,random,1
OocytesTrisopterusStates5b,0.6929824352264404,0.6163637638092041,0.6143155097961426,10000,add,random,1
Optical,0.8992765545845032,4.076233625411987,6.902027606964111,10000,add,random,1
Ozone,0.7302839159965515,2.143544912338257,2.7290537357330322,10000,add,random,1
PageBlocks,0.6323099136352539,4.28956413269043,4.894069671630859,10000,add,random,1
Parkinsons,0.8367347121238708,0.08369278907775879,0.1849358081817627,10000,add,random,1
Pendigits,0.8067467212677002,5.719403505325317,13.358240842819214,10000,add,random,1
Pima,0.6510416865348816,0.6027991771697998,0.816352128982544,10000,add,random,1
PittsburgBridgesMaterial,0.8846153616905212,0.06893253326416016,0.09435510635375977,10000,add,random,1
PittsburgBridgesRelL,0.5384615659713745,0.05765557289123535,0.1224822998046875,10000,add,random,1
PittsburgBridgesSpan,0.6521739363670349,0.05346846580505371,0.09370851516723633,10000,add,random,1
PittsburgBridgesTOrD,0.7200000286102295,0.06202363967895508,0.07702136039733887,10000,add,random,1
PittsburgBridgesType,0.5,0.06558561325073242,0.043419837951660156,10000,add,random,1
Planning,0.4444444477558136,0.12872815132141113,0.16766691207885742,10000,add,random,1
PlantMargin,0.7174999713897705,1.3538312911987305,1.6945252418518066,10000,add,random,1
PlantShape,0.19499999284744263,1.1704823970794678,1.755286693572998,10000,add,random,1
PlantTexture,0.7024999856948853,0.6295011043548584,1.2069916725158691,10000,add,random,1
PostOperative,0.40909090638160706,0.03638482093811035,0.10753107070922852,10000,add,random,1
PrimaryTumor,0.4878048896789551,0.2195286750793457,0.17132139205932617,10000,add,random,1
Ringnorm,0.9589189291000366,5.073829889297485,6.816169023513794,10000,add,random,1
Seeds,0.9038461446762085,0.15858960151672363,0.25494909286499023,10000,add,random,1
Semeion,0.8316583037376404,0.5839962959289551,1.2773122787475586,10000,add,random,1
Soybean,0.8164893388748169,0.2904388904571533,0.5865347385406494,10000,add,random,1
Spambase,0.8295652270317078,1.4664714336395264,1.6107590198516846,10000,add,random,1
Spect,0.5913978219032288,0.05652260780334473,0.3892338275909424,10000,add,random,1
Spectf,0.47058823704719543,0.05173349380493164,0.7696900367736816,10000,add,random,1
StatlogAustralianCredit,0.5,0.595233678817749,0.4779069423675537,10000,add,random,1
StatlogGermanCredit,0.7039999961853027,0.6102514266967773,0.3500964641571045,10000,add,random,1
StatlogHeart,0.8507462739944458,0.20691156387329102,0.3191368579864502,10000,add,random,1
StatlogImage,0.8162911534309387,0.8253414630889893,1.2789552211761475,10000,add,random,1
StatlogLandsat,0.8029999732971191,2.9050381183624268,6.4585936069488525,10000,add,random,1
StatlogShuttle,0.057379309087991714,39.80950713157654,41.97818636894226,10000,add,random,1
StatlogVehicle,0.578199028968811,0.6823234558105469,0.29871106147766113,10000,add,random,1
SteelPlates,0.49690720438957214,0.9644160270690918,0.7233500480651855,10000,add,random,1
SyntheticControl,0.8399999737739563,0.39909982681274414,0.5300071239471436,10000,add,random,1
Teaching,0.5526315569877625,0.0783073902130127,0.10717153549194336,10000,add,random,1
Thyroid,0.47987163066864014,1.7024765014648438,5.281952142715454,10000,add,random,1
TicTacToe,0.569037675857544,0.7425758838653564,0.33486151695251465,10000,add,random,1
Titanic,0.7818182110786438,1.0961215496063232,0.7895700931549072,10000,add,random,1
Trains,1.0,0.0073778629302978516,0.007706403732299805,10000,add,random,1
Twonorm,0.6718918681144714,2.441856861114502,3.0755488872528076,10000,add,random,1
VertebralColumn2Clases,0.7792207598686218,0.16994333267211914,0.3717916011810303,10000,add,random,1
VertebralColumn3Clases,0.7142857313156128,0.17021656036376953,0.2510545253753662,10000,add,random,1
WallFollowing,0.5454545617103577,3.260298490524292,1.9125194549560547,10000,add,random,1
Waveform,0.823199987411499,3.856442928314209,1.7497332096099854,10000,add,random,1
WaveformNoise,0.7968000173568726,3.329038381576538,1.755793809890747,10000,add,random,1
Wine,0.9545454382896423,0.11293315887451172,0.21520471572875977,10000,add,random,1
WineQualityRed,0.2824999988079071,0.8349630832672119,0.5846948623657227,10000,add,random,1
WineQualityWhite,0.36764705181121826,4.313739776611328,5.473915338516235,10000,add,random,1
Yeast,0.5363881587982178,0.5949695110321045,0.5219242572784424,10000,add,random,1
Zoo,0.9599999785423279,0.05145072937011719,0.062461137771606445,10000,add,random,1
Abalone,0.5440613031387329,3.498208522796631,4.525947093963623,10000,add,sinusoid,1
AcuteInflammation,1.0,0.07477855682373047,0.14810895919799805,10000,add,sinusoid,1
AcuteNephritis,1.0,0.0726768970489502,0.15102410316467285,10000,add,sinusoid,1
Adult,0.6933234930038452,26.21597671508789,49.54874229431152,10000,add,sinusoid,1
Annealing,0.7799999713897705,0.7555913925170898,0.14733219146728516,10000,add,sinusoid,1
Arrhythmia,0.37168142199516296,0.210435152053833,0.40845775604248047,10000,add,sinusoid,1
AudiologyStd,0.800000011920929,0.16350984573364258,0.127791166305542,10000,add,sinusoid,1
BalanceScale,0.7820512652397156,0.5734496116638184,0.25703001022338867,10000,add,sinusoid,1
Balloons,1.0,0.009824991226196289,0.012246370315551758,10000,add,sinusoid,1
Bank,0.6115044355392456,1.865971326828003,1.6440811157226562,10000,add,sinusoid,1
Blood,0.5347593426704407,0.3368265628814697,0.27171921730041504,10000,add,sinusoid,1
BreastCancer,0.7183098793029785,0.1404130458831787,0.35216236114501953,10000,add,sinusoid,1
BreastCancerWisc,0.954285740852356,0.521127462387085,0.870640754699707,10000,add,sinusoid,1
BreastCancerWiscDiag,0.908450722694397,0.48476552963256836,0.30432677268981934,10000,add,sinusoid,1
BreastCancerWiscProg,0.5306122303009033,0.11220121383666992,0.2438817024230957,10000,add,sinusoid,1
BreastTissue,0.7307692170143127,0.07488322257995605,0.11154723167419434,10000,add,sinusoid,1
Car,0.7638888955116272,0.5954113006591797,0.6230089664459229,10000,add,sinusoid,1
Cardiotocography10Clases,0.5800376534461975,2.143751382827759,1.018106460571289,10000,add,sinusoid,1
Cardiotocography3Clases,0.7853107452392578,0.7673306465148926,0.7702102661132812,10000,add,sinusoid,1
ChessKrvk,0.2445109784603119,13.943252086639404,18.401838541030884,10000,add,sinusoid,1
ChessKrvkp,0.8648310303688049,1.426008939743042,1.1513903141021729,10000,add,sinusoid,1
CongressionalVoting,0.5412843823432922,0.286210298538208,0.5417079925537109,10000,add,sinusoid,1
ConnBenchSonarMinesRocks,0.6346153616905212,0.11590099334716797,0.07819652557373047,10000,add,sinusoid,1
ConnBenchVowelDeterding,0.8549783825874329,0.6345784664154053,1.465135097503662,10000,add,sinusoid,1
Connect4,0.5729764699935913,29.266114473342896,40.69722533226013,10000,add,sinusoid,1
Contrac,0.489130437374115,0.9825804233551025,0.5348656177520752,10000,add,sinusoid,1
CreditApproval,0.854651153087616,0.37370729446411133,0.3829994201660156,10000,add,sinusoid,1
CylinderBands,0.6796875,0.42583608627319336,0.22370409965515137,10000,add,sinusoid,1
Dermatology,0.9670329689979553,0.3318030834197998,0.4528770446777344,10000,add,sinusoid,1
Echocardiogram,0.8787878751754761,0.0461735725402832,0.04893612861633301,10000,add,sinusoid,1
Ecoli,0.7976190447807312,0.3108532428741455,0.42050981521606445,10000,add,sinusoid,1
EnergyY1,0.8489583134651184,0.3305389881134033,0.8252437114715576,10000,add,sinusoid,1
EnergyY2,0.8229166865348816,0.7253932952880859,0.8616073131561279,10000,add,sinusoid,1
Fertility,0.7599999904632568,0.06589078903198242,0.07863044738769531,10000,add,sinusoid,1
Flags,0.4583333432674408,0.16400790214538574,0.08715295791625977,10000,add,sinusoid,1
Glass,0.5283018946647644,0.12393474578857422,0.1328105926513672,10000,add,sinusoid,1
HabermanSurvival,0.6710526347160339,0.29965806007385254,0.36231064796447754,10000,add,sinusoid,1
HayesRoth,0.6071428656578064,0.13640880584716797,0.1413576602935791,10000,add,sinusoid,1
HeartCleveland,0.5263158082962036,0.28018712997436523,0.284639835357666,10000,add,sinusoid,1
HeartHungarian,0.767123281955719,0.15474152565002441,0.2606496810913086,10000,add,sinusoid,1
HeartSwitzerland,0.4838709533214569,0.08134603500366211,0.047907352447509766,10000,add,sinusoid,1
HeartVa,0.2199999988079071,0.16938996315002441,0.2511582374572754,10000,add,sinusoid,1
Hepatitis,0.8461538553237915,0.09561944007873535,0.05678677558898926,10000,add,sinusoid,1
HillValley,0.5742574334144592,0.726463794708252,2.445347785949707,10000,add,sinusoid,1
HorseColic,0.8088235259056091,0.3588707447052002,0.30937743186950684,10000,add,sinusoid,1
IlpdIndianLiver,0.6575342416763306,0.5541307926177979,0.5654780864715576,10000,add,sinusoid,1
ImageSegmentation,0.8271428346633911,0.2760460376739502,8.585554599761963,10000,add,sinusoid,1
Ionosphere,0.7727272510528564,0.2846205234527588,0.3929719924926758,10000,add,sinusoid,1
Iris,0.9729729890823364,0.1308903694152832,0.14534711837768555,10000,add,sinusoid,1
LedDisplay,0.7599999904632568,0.9753601551055908,0.8619861602783203,10000,add,sinusoid,1
Lenses,0.8333333134651184,0.017853498458862305,0.020640134811401367,10000,add,sinusoid,1
Letter,0.6474000215530396,16.51841640472412,10.543436765670776,10000,add,sinusoid,1
Libras,0.5777778029441833,0.18081998825073242,0.3965413570404053,10000,add,sinusoid,1
LowResSpect,0.7819548845291138,0.3266942501068115,0.5544919967651367,10000,add,sinusoid,1
LungCancer,0.375,0.017134666442871094,0.018860340118408203,10000,add,sinusoid,1
Lymphography,0.9459459185600281,0.10079550743103027,0.11816215515136719,10000,add,sinusoid,1
Magic,0.7627760171890259,15.6517014503479,16.842756748199463,10000,add,sinusoid,1
Mammographic,0.7749999761581421,0.8463592529296875,0.9957528114318848,10000,add,sinusoid,1
Miniboone,0.28444457054138184,76.04549217224121,55.03382658958435,10000,add,sinusoid,1
MolecBiolPromoter,0.8846153616905212,0.0521998405456543,0.08940935134887695,10000,add,sinusoid,1
MolecBiolSplice,0.7666248679161072,1.9581844806671143,1.2398104667663574,10000,add,sinusoid,1
Monks1,0.6689814925193787,0.12717294692993164,2.133941411972046,10000,add,sinusoid,1
Monks2,0.6388888955116272,0.11813116073608398,1.3157877922058105,10000,add,sinusoid,1
Monks3,0.8032407164573669,0.11191582679748535,1.4117915630340576,10000,add,sinusoid,1
Mushroom,0.8793697953224182,2.9996299743652344,2.9429664611816406,10000,add,sinusoid,1
Musk1,0.5966386795043945,0.3923308849334717,0.5985727310180664,10000,add,sinusoid,1
Musk2,0.7562158703804016,2.7539889812469482,2.8684332370758057,10000,add,sinusoid,1
Nursery,0.825308620929718,9.269777774810791,9.964686393737793,10000,add,sinusoid,1
OocytesMerlucciusNucleus4d,0.615686297416687,0.449876070022583,0.854672908782959,10000,add,sinusoid,1
OocytesMerlucciusStates2f,0.8509804010391235,0.9701268672943115,1.0891222953796387,10000,add,sinusoid,1
OocytesTrisopterusNucleus2f,0.5614035129547119,0.7676982879638672,1.0595333576202393,10000,add,sinusoid,1
OocytesTrisopterusStates5b,0.6798245906829834,0.8048107624053955,1.1064343452453613,10000,add,sinusoid,1
Optical,0.908180296421051,4.397417306900024,6.12830924987793,10000,add,sinusoid,1
Ozone,0.7444794774055481,2.4398210048675537,2.8786849975585938,10000,add,sinusoid,1
PageBlocks,0.6995614171028137,4.850124359130859,4.406194686889648,10000,add,sinusoid,1
Parkinsons,0.8367347121238708,0.08840727806091309,0.14040875434875488,10000,add,sinusoid,1
Pendigits,0.8107489943504333,7.400850534439087,10.591062784194946,10000,add,sinusoid,1
Pima,0.671875,0.6838853359222412,0.9132626056671143,10000,add,sinusoid,1
PittsburgBridgesMaterial,0.8846153616905212,0.0778505802154541,0.062287092208862305,10000,add,sinusoid,1
PittsburgBridgesRelL,0.5,0.06065940856933594,0.12774348258972168,10000,add,sinusoid,1
PittsburgBridgesSpan,0.739130437374115,0.06131768226623535,0.11607122421264648,10000,add,sinusoid,1
PittsburgBridgesTOrD,0.7599999904632568,0.06829619407653809,0.12664389610290527,10000,add,sinusoid,1
PittsburgBridgesType,0.6538461446762085,0.08280801773071289,0.11262154579162598,10000,add,sinusoid,1
Planning,0.46666666865348816,0.1396312713623047,0.06809830665588379,10000,add,sinusoid,1
PlantMargin,0.7350000143051147,1.5689489841461182,1.8137891292572021,10000,add,sinusoid,1
PlantShape,0.3174999952316284,1.5374479293823242,1.1902275085449219,10000,add,sinusoid,1
PlantTexture,0.7149999737739563,1.5487515926361084,0.6268558502197266,10000,add,sinusoid,1
PostOperative,0.4545454680919647,0.03853726387023926,0.04537534713745117,10000,add,sinusoid,1
PrimaryTumor,0.5121951103210449,0.24077773094177246,0.4093477725982666,10000,add,sinusoid,1
Ringnorm,0.9599999785423279,6.759756565093994,2.678809404373169,10000,add,sinusoid,1
Seeds,0.9230769276618958,0.18636178970336914,0.2588346004486084,10000,add,sinusoid,1
Semeion,0.8492462038993835,1.5870983600616455,1.9808671474456787,10000,add,sinusoid,1
Soybean,0.8271276354789734,0.32633090019226074,1.8751256465911865,10000,add,sinusoid,1
Spambase,0.8269565105438232,3.943887233734131,5.185929536819458,10000,add,sinusoid,1
Spect,0.5430107712745667,0.05654263496398926,0.6129534244537354,10000,add,sinusoid,1
Spectf,0.45989304780960083,0.08246183395385742,0.5562353134155273,10000,add,sinusoid,1
StatlogAustralianCredit,0.5116279125213623,0.6526236534118652,0.8549907207489014,10000,add,sinusoid,1
StatlogGermanCredit,0.7120000123977661,0.9921646118164062,1.242527961730957,10000,add,sinusoid,1
StatlogHeart,0.8805969953536987,0.1908423900604248,0.3332240581512451,10000,add,sinusoid,1
StatlogImage,0.8266897797584534,2.36513352394104,2.8694801330566406,10000,add,sinusoid,1
StatlogLandsat,0.8205000162124634,1.9221792221069336,2.879760980606079,10000,add,sinusoid,1
StatlogShuttle,0.05731034651398659,46.272052526474,50.022005796432495,10000,add,sinusoid,1
StatlogVehicle,0.5545023679733276,0.501990556716919,0.5880091190338135,10000,add,sinusoid,1
SteelPlates,0.5154638886451721,0.8118865489959717,2.0746352672576904,10000,add,sinusoid,1
SyntheticControl,0.9333333373069763,0.5541102886199951,0.6503016948699951,10000,add,sinusoid,1
Teaching,0.5789473652839661,0.07976222038269043,0.11795783042907715,10000,add,sinusoid,1
Thyroid,0.5125437378883362,3.399768590927124,13.0197012424469,10000,add,sinusoid,1
TicTacToe,0.6150627732276917,0.8228600025177002,1.04764986038208,10000,add,sinusoid,1
Titanic,0.7836363911628723,1.8887698650360107,2.242034912109375,10000,add,sinusoid,1
Trains,1.0,0.007647275924682617,0.00739288330078125,10000,add,sinusoid,1
Twonorm,0.9675675630569458,3.454230546951294,3.0632688999176025,10000,add,sinusoid,1
VertebralColumn2Clases,0.7792207598686218,0.22451567649841309,0.3811962604522705,10000,add,sinusoid,1
VertebralColumn3Clases,0.6753246784210205,0.25523853302001953,0.38480234146118164,10000,add,sinusoid,1
WallFollowing,0.5601173043251038,5.3602135181427,6.182587623596191,10000,add,sinusoid,1
Waveform,0.8335999846458435,4.097895860671997,5.675521373748779,10000,add,sinusoid,1
WaveformNoise,0.7960000038146973,3.8237714767456055,5.000249624252319,10000,add,sinusoid,1
Wine,0.9772727489471436,0.08802461624145508,0.17682218551635742,10000,add,sinusoid,1
WineQualityRed,0.29499998688697815,1.2833683490753174,1.5840604305267334,10000,add,sinusoid,1
WineQualityWhite,0.3660130798816681,4.443588018417358,5.247307777404785,10000,add,sinusoid,1
Yeast,0.5390835404396057,1.2433996200561523,1.4983139038085938,10000,add,sinusoid,1
Zoo,0.9599999785423279,0.05843663215637207,0.12496304512023926,10000,add,sinusoid,1
Abalone,0.561302661895752,7.94891881942749,6.77880334854126,10000,add,generic,1
AcuteInflammation,1.0,0.2565732002258301,0.06546664237976074,10000,add,generic,1
AcuteNephritis,1.0,0.3292689323425293,0.1556704044342041,10000,add,generic,1
Adult,0.7067747712135315,127.35669660568237,107.69544076919556,10000,add,generic,1
Annealing,0.5299999713897705,8.36532187461853,1.126068353652954,10000,add,generic,1
Arrhythmia,0.3097345232963562,27.273796558380127,9.4139986038208,10000,add,generic,1
AudiologyStd,0.7599999904632568,3.5119073390960693,0.2590599060058594,10000,add,generic,1
BalanceScale,0.6346153616905212,1.0739691257476807,0.6996562480926514,10000,add,generic,1
Balloons,0.5,0.012622833251953125,0.009456872940063477,10000,add,generic,1
Bank,0.6955752372741699,15.36023497581482,7.963283538818359,10000,add,generic,1
Blood,0.5401069521903992,0.9505524635314941,0.34566402435302734,10000,add,generic,1
BreastCancer,0.7323943376541138,0.40445947647094727,0.35153651237487793,10000,add,generic,1
BreastCancerWisc,0.9485714435577393,1.2316393852233887,0.4609091281890869,10000,add,generic,1
BreastCancerWiscDiag,0.9366196990013123,5.643038749694824,1.7609353065490723,10000,add,generic,1
BreastCancerWiscProg,0.5306122303009033,1.3916876316070557,0.6393578052520752,10000,add,generic,1
BreastTissue,0.692307710647583,0.15725922584533691,0.06784296035766602,10000,add,generic,1
Car,0.6574074029922485,2.902423858642578,1.8840792179107666,10000,add,generic,1
Cardiotocography10Clases,0.5838041305541992,10.472988367080688,4.553671598434448,10000,add,generic,1
Cardiotocography3Clases,0.7796609997749329,9.920263290405273,3.5729305744171143,10000,add,generic,1
ChessKrvk,0.24151696264743805,47.618701457977295,30.70953869819641,10000,add,generic,1
ChessKrvkp,0.8560701012611389,27.555673837661743,13.395613431930542,10000,add,generic,1
CongressionalVoting,0.5137614607810974,2.266179084777832,0.8790900707244873,10000,add,generic,1
ConnBenchSonarMinesRocks,0.75,3.6391468048095703,1.3597614765167236,10000,add,generic,1
ConnBenchVowelDeterding,0.7813853025436401,2.696587562561035,3.4392387866973877,10000,add,generic,1
Connect4,0.6745811104774475,638.6132273674011,241.72211623191833,10000,add,generic,1
Contrac,0.47826087474823,3.8506174087524414,2.004397392272949,10000,add,generic,1
CreditApproval,0.8430232405662537,2.298027992248535,0.637822151184082,10000,add,generic,1
CylinderBands,0.6953125,3.4024014472961426,1.560103416442871,10000,add,generic,1
Dermatology,0.9780219793319702,2.7757179737091064,0.8880021572113037,10000,add,generic,1
Echocardiogram,0.8181818127632141,0.38902974128723145,0.32320094108581543,10000,add,generic,1
Ecoli,0.8095238208770752,0.766655683517456,0.5677266120910645,10000,add,generic,1
EnergyY1,0.8333333134651184,2.0127081871032715,1.0596485137939453,10000,add,generic,1
EnergyY2,0.8489583134651184,1.7107219696044922,0.6689295768737793,10000,add,generic,1
Fertility,0.6399999856948853,0.3221724033355713,0.13025689125061035,10000,add,generic,1
Flags,0.4583333432674408,1.464792251586914,0.6022324562072754,10000,add,generic,1
Glass,0.5094339847564697,0.721827507019043,0.21720337867736816,10000,add,generic,1
HabermanSurvival,0.5789473652839661,0.32932233810424805,0.41680169105529785,10000,add,generic,1
HayesRoth,0.6428571343421936,0.11084342002868652,0.15099859237670898,10000,add,generic,1
HeartCleveland,0.5526315569877625,1.0459578037261963,0.5359337329864502,10000,add,generic,1
HeartHungarian,0.7808219194412231,0.5538582801818848,0.6322228908538818,10000,add,generic,1
HeartSwitzerland,0.32258063554763794,0.5605549812316895,0.33666133880615234,10000,add,generic,1
HeartVa,0.36000001430511475,0.9464476108551025,0.2073047161102295,10000,add,generic,1
Hepatitis,0.8717948794364929,1.249507188796997,0.5773894786834717,10000,add,generic,1
HillValley,0.5082508325576782,13.423487901687622,11.42514443397522,10000,add,generic,1
HorseColic,0.7058823704719543,2.01238751411438,0.362562894821167,10000,add,generic,1
IlpdIndianLiver,0.6780821681022644,2.368415117263794,0.5955348014831543,10000,add,generic,1
ImageSegmentation,0.8185714483261108,1.8013713359832764,10.84515643119812,10000,add,generic,1
Ionosphere,0.7954545617103577,1.7655575275421143,0.58809494972229,10000,add,generic,1
Iris,0.9729729890823364,0.26291728019714355,0.23513245582580566,10000,add,generic,1
LedDisplay,0.6480000019073486,2.698326349258423,0.6050939559936523,10000,add,generic,1
Lenses,0.8333333134651184,0.022881031036376953,0.03220200538635254,10000,add,generic,1
Letter,0.6980000138282776,73.76212406158447,36.02413487434387,10000,add,generic,1
Libras,0.5888888835906982,7.385061502456665,1.7064039707183838,10000,add,generic,1
LowResSpect,0.7669172883033752,15.8725106716156,4.33622670173645,10000,add,generic,1
LungCancer,0.25,0.44840240478515625,0.29342174530029297,10000,add,generic,1
Lymphography,0.8108108043670654,1.1740994453430176,0.5350947380065918,10000,add,generic,1
Magic,0.7440589070320129,41.72170948982239,16.79697895050049,10000,add,generic,1
Mammographic,0.7708333134651184,1.011854887008667,0.4988994598388672,10000,add,generic,1
Miniboone,0.2856132388114929,1380.7041351795197,520.1926901340485,10000,add,generic,1
MolecBiolPromoter,0.8846153616905212,1.3569436073303223,0.5422525405883789,10000,add,generic,1
MolecBiolSplice,0.8808029890060425,42.794777154922485,15.594813585281372,10000,add,generic,1
Monks1,0.6736111044883728,0.30548667907714844,1.7248849868774414,10000,add,generic,1
Monks2,0.6180555820465088,0.2977485656738281,1.6556148529052734,10000,add,generic,1
Monks3,0.8472222089767456,0.3506331443786621,1.6300370693206787,10000,add,generic,1
Mushroom,0.8862629532814026,42.03633952140808,16.333767414093018,10000,add,generic,1
Musk1,0.5882353186607361,16.40522074699402,5.718241214752197,10000,add,generic,1
Musk2,0.7537901997566223,228.79212880134583,90.04877638816833,10000,add,generic,1
Nursery,0.7265431880950928,23.742257356643677,12.481345653533936,10000,add,generic,1
OocytesMerlucciusNucleus4d,0.6078431606292725,11.096393346786499,2.668677806854248,10000,add,generic,1
OocytesMerlucciusStates2f,0.8392156958580017,6.116449594497681,2.7158138751983643,10000,add,generic,1
OocytesTrisopterusNucleus2f,0.6140350699424744,5.456720352172852,2.596130609512329,10000,add,generic,1
OocytesTrisopterusStates5b,0.7061403393745422,5.0601115226745605,2.004870653152466,10000,add,generic,1
Optical,0.904841423034668,65.12124300003052,32.52475666999817,10000,add,generic,1
Ozone,0.7460567951202393,35.48034310340881,14.250917673110962,10000,add,generic,1
PageBlocks,0.7682748436927795,14.172287702560425,7.500143527984619,10000,add,generic,1
Parkinsons,0.8163265585899353,1.1115987300872803,0.4727776050567627,10000,add,generic,1
Pendigits,0.7893081903457642,35.95074272155762,24.31046772003174,10000,add,generic,1
Pima,0.6666666865348816,1.8746607303619385,0.49683499336242676,10000,add,generic,1
PittsburgBridgesMaterial,0.8846153616905212,0.3105504512786865,0.21239423751831055,10000,add,generic,1
PittsburgBridgesRelL,0.692307710647583,0.19227313995361328,0.06412553787231445,10000,add,generic,1
PittsburgBridgesSpan,0.5652173757553101,0.2272496223449707,0.187211275100708,10000,add,generic,1
PittsburgBridgesTOrD,0.9200000166893005,0.20180702209472656,0.06190156936645508,10000,add,generic,1
PittsburgBridgesType,0.5769230723381042,0.31629109382629395,0.11823630332946777,10000,add,generic,1
Planning,0.46666666865348816,0.5594215393066406,0.14646315574645996,10000,add,generic,1
PlantMargin,0.7674999833106995,24.385375261306763,7.787757396697998,10000,add,generic,1
PlantShape,0.3499999940395355,23.398160457611084,6.645050525665283,10000,add,generic,1
PlantTexture,0.7275000214576721,23.59670901298523,5.6165711879730225,10000,add,generic,1
PostOperative,0.3636363744735718,0.11271262168884277,0.18457436561584473,10000,add,generic,1
PrimaryTumor,0.45121949911117554,2.30967378616333,1.1197309494018555,10000,add,generic,1
Ringnorm,0.9464864730834961,25.116538763046265,14.51766037940979,10000,add,generic,1
Seeds,0.8653846383094788,0.46241164207458496,0.12627315521240234,10000,add,generic,1
Semeion,0.8542713522911072,74.27151727676392,27.085647583007812,10000,add,generic,1
Soybean,0.8563829660415649,2.769054412841797,4.026533365249634,10000,add,generic,1
Spambase,0.8269565105438232,43.01637077331543,19.196353435516357,10000,add,generic,1
Spect,0.6182795763015747,0.7132408618927002,1.85585618019104,10000,add,generic,1
Spectf,0.3903743326663971,0.857241153717041,2.9668147563934326,10000,add,generic,1
StatlogAustralianCredit,0.5406976938247681,2.722686767578125,2.072735548019409,10000,add,generic,1
StatlogGermanCredit,0.6359999775886536,7.2468671798706055,2.308429479598999,10000,add,generic,1
StatlogHeart,0.8358209133148193,1.2304813861846924,0.3302650451660156,10000,add,generic,1
StatlogImage,0.8734835386276245,7.511063575744629,3.3463778495788574,10000,add,generic,1
StatlogLandsat,0.7954999804496765,45.96221208572388,22.31499218940735,10000,add,generic,1
StatlogShuttle,0.05779310315847397,120.10147190093994,68.86689615249634,10000,add,generic,1
StatlogVehicle,0.521327018737793,2.3956902027130127,1.4569272994995117,10000,add,generic,1
SteelPlates,0.5608247518539429,12.634322881698608,4.743168592453003,10000,add,generic,1
SyntheticControl,0.9333333373069763,10.315216064453125,3.398219108581543,10000,add,generic,1
Teaching,0.4736842215061188,0.3600170612335205,0.22638940811157227,10000,add,generic,1
Thyroid,0.4848307967185974,25.525913953781128,33.41646122932434,10000,add,generic,1
TicTacToe,0.6778242588043213,2.479482889175415,0.9673571586608887,10000,add,generic,1
Titanic,0.7872727513313293,2.0031089782714844,1.7380650043487549,10000,add,generic,1
Trains,0.5,0.07850956916809082,0.013133049011230469,10000,add,generic,1
Twonorm,0.9729729890823364,31.927870750427246,15.13988709449768,10000,add,generic,1
VertebralColumn2Clases,0.7662337422370911,0.505354642868042,0.3703474998474121,10000,add,generic,1
VertebralColumn3Clases,0.4935064911842346,0.5068607330322266,0.39763951301574707,10000,add,generic,1
WallFollowing,0.6642228960990906,21.911561250686646,11.254987478256226,10000,add,generic,1
Waveform,0.8256000280380249,21.161593914031982,9.841422080993652,10000,add,generic,1
WaveformNoise,0.795199990272522,44.620473861694336,18.38192391395569,10000,add,generic,1
Wine,0.8863636255264282,0.8213636875152588,0.4589993953704834,10000,add,generic,1
WineQualityRed,0.3425000011920929,4.26593542098999,2.450129985809326,10000,add,generic,1
WineQualityWhite,0.30310457944869995,9.011501550674438,4.96729302406311,10000,add,generic,1
Yeast,0.493261456489563,2.6295230388641357,1.1431398391723633,10000,add,generic,1
Zoo,0.9599999785423279,0.6838192939758301,0.33596372604370117,10000,add,generic,1
