Name,Accuracy,TrainTime,TestTime,Dimensions,Method,Encoding,Iterations
Abalone,0.5785440802574158,5.514911413192749,2.668689012527466,10000,adapt,flocet,1
AcuteInflammation,1.0,0.1939103603363037,0.050231218338012695,10000,adapt,flocet,1
AcuteNephritis,1.0,0.2663567066192627,0.16204237937927246,10000,adapt,flocet,1
Adult,0.7837356328964233,52.52267098426819,43.75256013870239,10000,adapt,flocet,1
Annealing,0.8500000238418579,1.4654335975646973,0.1726090908050537,10000,adapt,flocet,1
Arrhythmia,0.06194690242409706,0.6809208393096924,0.5480310916900635,10000,adapt,flocet,1
AudiologyStd,0.6399999856948853,0.39162302017211914,0.13772797584533691,10000,adapt,flocet,1
BalanceScale,0.9166666865348816,1.0503084659576416,0.3583104610443115,10000,adapt,flocet,1
Balloons,0.75,0.04007148742675781,0.023418426513671875,10000,adapt,flocet,1
Bank,0.8946902751922607,5.32595419883728,3.6941614151000977,10000,adapt,flocet,1
Blood,0.7486631274223328,1.047386884689331,0.2925269603729248,10000,adapt,flocet,1
BreastCancer,0.591549277305603,0.6510770320892334,0.34404420852661133,10000,adapt,flocet,1
BreastCancerWisc,0.954285740852356,1.012500286102295,0.7527854442596436,10000,adapt,flocet,1
BreastCancerWiscDiag,0.98591548204422,0.6481828689575195,0.2233293056488037,10000,adapt,flocet,1
BreastCancerWiscProg,0.5714285969734192,0.4822871685028076,0.22478389739990234,10000,adapt,flocet,1
BreastTissue,0.7307692170143127,0.15705442428588867,0.043776750564575195,10000,adapt,flocet,1
Car,0.8356481194496155,2.4332334995269775,1.604020595550537,10000,adapt,flocet,1
Cardiotocography10Clases,0.6534839868545532,3.209477186203003,0.9140565395355225,10000,adapt,flocet,1
Cardiotocography3Clases,0.8474576473236084,3.1695430278778076,1.7167294025421143,10000,adapt,flocet,1
ChessKrvk,0.3853721022605896,39.72941875457764,20.890226364135742,10000,adapt,flocet,1
ChessKrvkp,0.948685884475708,3.8536698818206787,2.5985307693481445,10000,adapt,flocet,1
CongressionalVoting,0.6238532066345215,0.8905017375946045,0.17171907424926758,10000,adapt,flocet,1
ConnBenchSonarMinesRocks,0.692307710647583,0.3832371234893799,0.08242416381835938,10000,adapt,flocet,1
ConnBenchVowelDeterding,0.6883116960525513,0.9509546756744385,1.3822202682495117,10000,adapt,flocet,1
Connect4,0.809935450553894,87.82046365737915,45.15251874923706,10000,adapt,flocet,1
Contrac,0.41847825050354004,2.327481746673584,1.1274032592773438,10000,adapt,flocet,1
CreditApproval,0.7965116500854492,0.9983279705047607,0.6270856857299805,10000,adapt,flocet,1
CylinderBands,0.6875,1.2417192459106445,0.21998095512390137,10000,adapt,flocet,1
Dermatology,0.9670329689979553,0.37526559829711914,0.1939713954925537,10000,adapt,flocet,1
Echocardiogram,0.8787878751754761,0.27651119232177734,0.07402825355529785,10000,adapt,flocet,1
Ecoli,0.6904761791229248,0.6560466289520264,0.13567042350769043,10000,adapt,flocet,1
EnergyY1,0.890625,1.1464695930480957,0.6187975406646729,10000,adapt,flocet,1
EnergyY2,0.7760416865348816,1.5858161449432373,0.4223024845123291,10000,adapt,flocet,1
Fertility,0.8799999952316284,0.1649792194366455,0.1359407901763916,10000,adapt,flocet,1
Flags,0.4791666567325592,0.25750184059143066,0.07624483108520508,10000,adapt,flocet,1
Glass,0.3962264060974121,0.42341136932373047,0.08747529983520508,10000,adapt,flocet,1
HabermanSurvival,0.5526315569877625,0.5608456134796143,0.22235536575317383,10000,adapt,flocet,1
HayesRoth,0.5357142686843872,0.35292911529541016,0.04557037353515625,10000,adapt,flocet,1
HeartCleveland,0.6447368264198303,0.5493288040161133,0.16684579849243164,10000,adapt,flocet,1
HeartHungarian,0.7534246444702148,0.626885175704956,0.13320159912109375,10000,adapt,flocet,1
HeartSwitzerland,0.32258063554763794,0.14412140846252441,0.14281845092773438,10000,adapt,flocet,1
HeartVa,0.18000000715255737,0.24303722381591797,0.0796048641204834,10000,adapt,flocet,1
Hepatitis,0.6666666865348816,0.3639094829559326,0.21170353889465332,10000,adapt,flocet,1
HillValley,0.5198019742965698,1.34246826171875,1.4459905624389648,10000,adapt,flocet,1
HorseColic,0.7352941036224365,0.8064963817596436,0.10701513290405273,10000,adapt,flocet,1
IlpdIndianLiver,0.7123287916183472,1.0459177494049072,0.5677139759063721,10000,adapt,flocet,1
ImageSegmentation,0.7157142758369446,0.49303269386291504,6.2314465045928955,10000,adapt,flocet,1
Ionosphere,0.9204545617103577,0.48280787467956543,0.1378781795501709,10000,adapt,flocet,1
Iris,0.9189189076423645,0.2910890579223633,0.20032048225402832,10000,adapt,flocet,1
LedDisplay,0.5920000076293945,1.3855829238891602,0.8948299884796143,10000,adapt,flocet,1
Lenses,0.8333333134651184,0.060806989669799805,0.03430581092834473,10000,adapt,flocet,1
Letter,0.7712000012397766,25.48919987678528,13.422043323516846,10000,adapt,flocet,1
Libras,0.5666666626930237,0.7681925296783447,0.4361457824707031,10000,adapt,flocet,1
LowResSpect,0.8195488452911377,1.0913891792297363,0.6750695705413818,10000,adapt,flocet,1
LungCancer,0.25,0.06077384948730469,0.04490804672241211,10000,adapt,flocet,1
Lymphography,0.9729729890823364,0.264052152633667,0.17839622497558594,10000,adapt,flocet,1
Magic,0.7303890585899353,28.927372217178345,15.933202266693115,10000,adapt,flocet,1
Mammographic,0.6833333373069763,1.6516163349151611,0.45673370361328125,10000,adapt,flocet,1
Miniboone,0.7890269160270691,175.09777212142944,97.64390683174133,10000,adapt,flocet,1
MolecBiolPromoter,0.9615384340286255,0.25754427909851074,0.0872342586517334,10000,adapt,flocet,1
MolecBiolSplice,0.8030112981796265,4.805677890777588,2.6742703914642334,10000,adapt,flocet,1
Monks1,0.6851851940155029,0.3843104839324951,1.6448900699615479,10000,adapt,flocet,1
Monks2,0.9444444179534912,0.5323402881622314,1.1450037956237793,10000,adapt,flocet,1
Monks3,0.875,0.38793253898620605,1.5205278396606445,10000,adapt,flocet,1
Mushroom,0.9995076060295105,9.558837652206421,6.744564771652222,10000,adapt,flocet,1
Musk1,0.6722689270973206,0.4770026206970215,0.19070005416870117,10000,adapt,flocet,1
Musk2,0.9539114832878113,9.766282081604004,4.351816654205322,10000,adapt,flocet,1
Nursery,0.9441357851028442,19.2833468914032,9.882146835327148,10000,adapt,flocet,1
OocytesMerlucciusNucleus4d,0.7019608020782471,1.8379333019256592,0.7534797191619873,10000,adapt,flocet,1
OocytesMerlucciusStates2f,0.8274509906768799,1.385178804397583,0.9352157115936279,10000,adapt,flocet,1
OocytesTrisopterusNucleus2f,0.640350878238678,1.1563639640808105,1.113173246383667,10000,adapt,flocet,1
OocytesTrisopterusStates5b,0.9166666865348816,1.5112042427062988,0.5025203227996826,10000,adapt,flocet,1
Optical,0.910406231880188,6.725811958312988,6.103433132171631,10000,adapt,flocet,1
Ozone,0.9479495286941528,3.804823875427246,2.1275277137756348,10000,adapt,flocet,1
PageBlocks,0.9261695742607117,6.731914758682251,5.060788869857788,10000,adapt,flocet,1
Parkinsons,0.8571428656578064,0.45807623863220215,0.152130126953125,10000,adapt,flocet,1
Pendigits,0.9210977554321289,12.76611614227295,10.671456575393677,10000,adapt,flocet,1
Pima,0.7083333134651184,0.8087387084960938,0.3011751174926758,10000,adapt,flocet,1
PittsburgBridgesMaterial,0.692307710647583,0.2519559860229492,0.06977725028991699,10000,adapt,flocet,1
PittsburgBridgesRelL,0.5769230723381042,0.17182540893554688,0.04233098030090332,10000,adapt,flocet,1
PittsburgBridgesSpan,0.695652186870575,0.23168396949768066,0.1252453327178955,10000,adapt,flocet,1
PittsburgBridgesTOrD,0.8799999952316284,0.16051435470581055,0.08862495422363281,10000,adapt,flocet,1
PittsburgBridgesType,0.5,0.08209800720214844,0.11408877372741699,10000,adapt,flocet,1
Planning,0.7333333492279053,0.311983585357666,0.07092738151550293,10000,adapt,flocet,1
PlantMargin,0.41999998688697815,2.824065685272217,1.3934075832366943,10000,adapt,flocet,1
PlantShape,0.11249999701976776,2.98832106590271,0.7645361423492432,10000,adapt,flocet,1
PlantTexture,0.4325000047683716,3.2606070041656494,1.743635654449463,10000,adapt,flocet,1
PostOperative,0.7272727489471436,0.19983768463134766,0.037143707275390625,10000,adapt,flocet,1
PrimaryTumor,0.2195121943950653,0.46434473991394043,0.20617198944091797,10000,adapt,flocet,1
Ringnorm,0.9427027106285095,8.41750693321228,6.874372243881226,10000,adapt,flocet,1
Seeds,0.8846153616905212,0.4921889305114746,0.2829148769378662,10000,adapt,flocet,1
Semeion,0.8994975090026855,2.435002326965332,1.5267207622528076,10000,adapt,flocet,1
Soybean,0.7686170339584351,0.771172046661377,1.4518787860870361,10000,adapt,flocet,1
Spambase,0.904347836971283,8.284095287322998,2.628385543823242,10000,adapt,flocet,1
Spect,0.5806451439857483,0.2600235939025879,0.7917029857635498,10000,adapt,flocet,1
Spectf,0.9197860956192017,0.14673089981079102,0.5439474582672119,10000,adapt,flocet,1
StatlogAustralianCredit,0.5523256063461304,1.329857587814331,0.7170653343200684,10000,adapt,flocet,1
StatlogGermanCredit,0.7440000176429749,1.8497638702392578,1.1073548793792725,10000,adapt,flocet,1
StatlogHeart,0.89552241563797,0.6338286399841309,0.31308698654174805,10000,adapt,flocet,1
StatlogImage,0.8873483538627625,3.9145348072052,1.6156926155090332,10000,adapt,flocet,1
StatlogLandsat,0.8215000033378601,9.502484560012817,7.342698335647583,10000,adapt,flocet,1
StatlogShuttle,0.8975172638893127,80.43657684326172,42.52234506607056,10000,adapt,flocet,1
StatlogVehicle,0.4644549787044525,1.2873327732086182,0.8076369762420654,10000,adapt,flocet,1
SteelPlates,0.5979381203651428,3.066779136657715,1.2417426109313965,10000,adapt,flocet,1
SyntheticControl,0.9399999976158142,0.6244566440582275,0.7443587779998779,10000,adapt,flocet,1
Teaching,0.42105263471603394,0.31812596321105957,0.20604991912841797,10000,adapt,flocet,1
Thyroid,0.9215285778045654,6.604592561721802,12.31117844581604,10000,adapt,flocet,1
TicTacToe,0.9707112908363342,1.8317320346832275,0.626619815826416,10000,adapt,flocet,1
Titanic,0.7599999904632568,4.070249795913696,2.568800449371338,10000,adapt,flocet,1
Trains,1.0,0.02464580535888672,0.012497186660766602,10000,adapt,flocet,1
Twonorm,0.9686486721038818,9.841105222702026,6.311678886413574,10000,adapt,flocet,1
VertebralColumn2Clases,0.7402597665786743,0.545154333114624,0.12107014656066895,10000,adapt,flocet,1
VertebralColumn3Clases,0.5844155550003052,0.4275834560394287,0.25815582275390625,10000,adapt,flocet,1
WallFollowing,0.7917888760566711,7.085476875305176,4.778370141983032,10000,adapt,flocet,1
Waveform,0.8295999765396118,6.170973777770996,3.3183488845825195,10000,adapt,flocet,1
WaveformNoise,0.7968000173568726,5.610923528671265,4.314054012298584,10000,adapt,flocet,1
Wine,0.9545454382896423,0.1303424835205078,0.0691838264465332,10000,adapt,flocet,1
WineQualityRed,0.5575000047683716,2.14599871635437,1.2215955257415771,10000,adapt,flocet,1
WineQualityWhite,0.4910130798816681,6.742303371429443,4.311799764633179,10000,adapt,flocet,1
Yeast,0.4959568679332733,1.5098443031311035,1.0880045890808105,10000,adapt,flocet,1
Zoo,0.9599999785423279,0.13856029510498047,0.13413619995117188,10000,adapt,flocet,1
Abalone,0.44252872467041016,7.024536848068237,3.141599655151367,10000,online,flocet,1
AcuteInflammation,1.0,0.0824122428894043,0.04754185676574707,10000,online,flocet,1
AcuteNephritis,1.0,0.2185046672821045,0.0489201545715332,10000,online,flocet,1
Adult,0.8112523555755615,61.94328188896179,57.358702659606934,10000,online,flocet,1
Annealing,0.6100000143051147,1.901050090789795,0.40043210983276367,10000,online,flocet,1
Arrhythmia,0.3097345232963562,0.6408421993255615,0.1886308193206787,10000,online,flocet,1
AudiologyStd,0.4000000059604645,0.5002553462982178,0.1365983486175537,10000,online,flocet,1
BalanceScale,0.8974359035491943,0.978705883026123,0.37944769859313965,10000,online,flocet,1
Balloons,0.75,0.023108482360839844,0.012056350708007812,10000,online,flocet,1
Bank,0.865486741065979,7.656569957733154,4.277669906616211,10000,online,flocet,1
Blood,0.6524063944816589,1.3247194290161133,0.8175227642059326,10000,online,flocet,1
BreastCancer,0.6760563254356384,0.7121875286102295,0.3061957359313965,10000,online,flocet,1
BreastCancerWisc,0.9657142758369446,1.1369082927703857,0.5338358879089355,10000,online,flocet,1
BreastCancerWiscDiag,0.9507042169570923,1.0859577655792236,0.5695650577545166,10000,online,flocet,1
BreastCancerWiscProg,0.795918345451355,0.5180530548095703,0.20853281021118164,10000,online,flocet,1
BreastTissue,0.6153846383094788,0.09447097778320312,0.05147719383239746,10000,online,flocet,1
Car,0.8981481194496155,2.277714490890503,1.85622239112854,10000,online,flocet,1
Cardiotocography10Clases,0.6986817121505737,4.085937023162842,2.34732985496521,10000,online,flocet,1
Cardiotocography3Clases,0.7758945226669312,3.470487117767334,1.6232216358184814,10000,online,flocet,1
ChessKrvk,0.41103506088256836,50.13730025291443,24.363051891326904,10000,online,flocet,1
ChessKrvkp,0.944931149482727,4.6623029708862305,2.8829028606414795,10000,online,flocet,1
CongressionalVoting,0.6238532066345215,0.935692310333252,0.46236205101013184,10000,online,flocet,1
ConnBenchSonarMinesRocks,0.8461538553237915,0.541419267654419,0.2676432132720947,10000,online,flocet,1
ConnBenchVowelDeterding,0.7857142686843872,1.0881760120391846,1.194162368774414,10000,online,flocet,1
Connect4,0.8153235912322998,106.58417415618896,57.045432329177856,10000,online,flocet,1
Contrac,0.4945652186870575,1.7678227424621582,1.214855432510376,10000,online,flocet,1
CreditApproval,0.7965116500854492,1.456228494644165,0.6192822456359863,10000,online,flocet,1
CylinderBands,0.7421875,1.0282304286956787,0.3285837173461914,10000,online,flocet,1
Dermatology,0.9340659379959106,0.6820206642150879,0.2608067989349365,10000,online,flocet,1
Echocardiogram,0.8484848737716675,0.3233358860015869,0.1690971851348877,10000,online,flocet,1
Ecoli,0.8095238208770752,0.741025447845459,0.1389002799987793,10000,online,flocet,1
EnergyY1,0.8697916865348816,1.6850323677062988,0.9539804458618164,10000,online,flocet,1
EnergyY2,0.7708333134651184,0.8283095359802246,0.7504312992095947,10000,online,flocet,1
Fertility,0.8799999952316284,0.24847817420959473,0.1359570026397705,10000,online,flocet,1
Flags,0.3958333432674408,0.3734579086303711,0.0767054557800293,10000,online,flocet,1
Glass,0.2641509473323822,0.5061056613922119,0.10004377365112305,10000,online,flocet,1
HabermanSurvival,0.5263158082962036,0.7189116477966309,0.1227262020111084,10000,online,flocet,1
HayesRoth,0.7857142686843872,0.45670437812805176,0.15395879745483398,10000,online,flocet,1
HeartCleveland,0.5394737124443054,0.7014040946960449,0.13463068008422852,10000,online,flocet,1
HeartHungarian,0.6438356041908264,0.6017303466796875,0.24180841445922852,10000,online,flocet,1
HeartSwitzerland,0.25806450843811035,0.29587841033935547,0.10209298133850098,10000,online,flocet,1
HeartVa,0.3199999928474426,0.4068467617034912,0.27048206329345703,10000,online,flocet,1
Hepatitis,0.6666666865348816,0.2219548225402832,0.21096515655517578,10000,online,flocet,1
HillValley,0.5214521288871765,1.068321704864502,1.2848773002624512,10000,online,flocet,1
HorseColic,0.7647058963775635,0.7723190784454346,0.20698118209838867,10000,online,flocet,1
IlpdIndianLiver,0.698630154132843,0.531426191329956,0.48832082748413086,10000,online,flocet,1
ImageSegmentation,0.8857142925262451,0.34653258323669434,5.23051381111145,10000,online,flocet,1
Ionosphere,0.9318181872367859,0.5036883354187012,0.13858509063720703,10000,online,flocet,1
Iris,0.9729729890823364,0.2538893222808838,0.06050848960876465,10000,online,flocet,1
LedDisplay,0.699999988079071,1.5867719650268555,0.46042680740356445,10000,online,flocet,1
Lenses,0.8333333134651184,0.06547403335571289,0.03427529335021973,10000,online,flocet,1
Letter,0.777400016784668,26.012299299240112,18.232543468475342,10000,online,flocet,1
Libras,0.5,0.7046279907226562,0.14220237731933594,10000,online,flocet,1
LowResSpect,0.7368420958518982,0.48778510093688965,0.45043396949768066,10000,online,flocet,1
LungCancer,0.625,0.05596661567687988,0.04491996765136719,10000,online,flocet,1
Lymphography,0.8918918967247009,0.3072986602783203,0.07506990432739258,10000,online,flocet,1
Magic,0.6937959790229797,26.698105335235596,17.31842017173767,10000,online,flocet,1
Mammographic,0.6791666746139526,1.2949554920196533,1.2411305904388428,10000,online,flocet,1
Miniboone,0.28459835052490234,198.40483331680298,107.87085175514221,10000,online,flocet,1
MolecBiolPromoter,0.9230769276618958,0.27403807640075684,0.13436555862426758,10000,online,flocet,1
MolecBiolSplice,0.7716436386108398,4.559731960296631,2.5403451919555664,10000,online,flocet,1
Monks1,0.6712962985038757,0.20920133590698242,1.1854593753814697,10000,online,flocet,1
Monks2,0.9212962985038757,0.5126633644104004,1.2816801071166992,10000,online,flocet,1
Monks3,0.8518518805503845,0.40853190422058105,1.492248296737671,10000,online,flocet,1
Mushroom,0.997538149356842,12.580465316772461,8.649463653564453,10000,online,flocet,1
Musk1,0.7899159789085388,0.9715766906738281,0.40146350860595703,10000,online,flocet,1
Musk2,0.8629472255706787,10.12610673904419,5.678090572357178,10000,online,flocet,1
Nursery,0.9484567642211914,22.082325220108032,9.946640491485596,10000,online,flocet,1
OocytesMerlucciusNucleus4d,0.48235294222831726,2.17673921585083,1.0847771167755127,10000,online,flocet,1
OocytesMerlucciusStates2f,0.8549019694328308,1.9503757953643799,1.0862362384796143,10000,online,flocet,1
OocytesTrisopterusNucleus2f,0.6359649300575256,0.8615067005157471,0.9931190013885498,10000,online,flocet,1
OocytesTrisopterusStates5b,0.7543859481811523,1.4272804260253906,0.7666394710540771,10000,online,flocet,1
Optical,0.9298831224441528,8.786136865615845,6.422475576400757,10000,online,flocet,1
Ozone,0.9684542417526245,4.428776025772095,2.706156015396118,10000,online,flocet,1
PageBlocks,0.942251443862915,8.174167394638062,4.967655420303345,10000,online,flocet,1
Parkinsons,0.8367347121238708,0.4731717109680176,0.267061710357666,10000,online,flocet,1
Pendigits,0.9216695427894592,16.057926416397095,11.56139063835144,10000,online,flocet,1
Pima,0.703125,1.6405746936798096,0.9274437427520752,10000,online,flocet,1
PittsburgBridgesMaterial,0.7307692170143127,0.2671194076538086,0.1421644687652588,10000,online,flocet,1
PittsburgBridgesRelL,0.5769230723381042,0.11887884140014648,0.0742795467376709,10000,online,flocet,1
PittsburgBridgesSpan,0.6521739363670349,0.24900412559509277,0.12577056884765625,10000,online,flocet,1
PittsburgBridgesTOrD,0.7200000286102295,0.07858610153198242,0.08671903610229492,10000,online,flocet,1
PittsburgBridgesType,0.4615384638309479,0.13445043563842773,0.04169487953186035,10000,online,flocet,1
Planning,0.4888888895511627,0.31096982955932617,0.1965031623840332,10000,online,flocet,1
PlantMargin,0.5350000262260437,3.5843775272369385,1.8825879096984863,10000,online,flocet,1
PlantShape,0.26249998807907104,2.254617691040039,1.713148593902588,10000,online,flocet,1
PlantTexture,0.5899999737739563,3.598665952682495,1.3481457233428955,10000,online,flocet,1
PostOperative,0.5,0.13228678703308105,0.03566241264343262,10000,online,flocet,1
PrimaryTumor,0.32926830649375916,0.8693447113037109,0.4448812007904053,10000,online,flocet,1
Ringnorm,0.9437837600708008,12.098193883895874,6.9486517906188965,10000,online,flocet,1
Seeds,0.8846153616905212,0.5102176666259766,0.21373367309570312,10000,online,flocet,1
Semeion,0.8417085409164429,2.426319122314453,1.3951506614685059,10000,online,flocet,1
Soybean,0.8643617033958435,0.7713043689727783,1.7637128829956055,10000,online,flocet,1
Spambase,0.7582608461380005,6.352637529373169,4.250712633132935,10000,online,flocet,1
Spect,0.6236559152603149,0.280637264251709,0.5065381526947021,10000,online,flocet,1
Spectf,0.5133689641952515,0.29074645042419434,0.7946996688842773,10000,online,flocet,1
StatlogAustralianCredit,0.6976743936538696,1.4065051078796387,0.6047813892364502,10000,online,flocet,1
StatlogGermanCredit,0.7559999823570251,1.8258037567138672,0.664405345916748,10000,online,flocet,1
StatlogHeart,0.8358209133148193,0.4806244373321533,0.3621346950531006,10000,online,flocet,1
StatlogImage,0.8942807912826538,3.2348737716674805,2.362042188644409,10000,online,flocet,1
StatlogLandsat,0.8460000157356262,8.190650701522827,5.694331645965576,10000,online,flocet,1
StatlogShuttle,0.348827600479126,77.84238386154175,44.00393223762512,10000,online,flocet,1
StatlogVehicle,0.6824644804000854,1.4127602577209473,0.42406201362609863,10000,online,flocet,1
SteelPlates,0.5814433097839355,3.1875460147857666,1.7215235233306885,10000,online,flocet,1
SyntheticControl,0.9800000190734863,0.7924721240997314,0.45053696632385254,10000,online,flocet,1
Teaching,0.3684210479259491,0.18858671188354492,0.06067228317260742,10000,online,flocet,1
Thyroid,0.9355309009552002,7.93015193939209,10.872636556625366,10000,online,flocet,1
TicTacToe,0.9372385144233704,1.3512935638427734,0.5393056869506836,10000,online,flocet,1
Titanic,0.7272727489471436,3.537116289138794,2.1229209899902344,10000,online,flocet,1
Trains,0.5,0.030196428298950195,0.012729406356811523,10000,online,flocet,1
Twonorm,0.9513513445854187,9.634052753448486,5.3211047649383545,10000,online,flocet,1
VertebralColumn2Clases,0.7662337422370911,0.5090982913970947,0.12087607383728027,10000,online,flocet,1
VertebralColumn3Clases,0.5974025726318359,0.7318496704101562,0.2718191146850586,10000,online,flocet,1
WallFollowing,0.9252199530601501,8.773605346679688,4.394369602203369,10000,online,flocet,1
Waveform,0.8047999739646912,6.453189849853516,4.461993455886841,10000,online,flocet,1
WaveformNoise,0.8119999766349792,7.386990308761597,3.3543717861175537,10000,online,flocet,1
Wine,1.0,0.28433799743652344,0.07021737098693848,10000,online,flocet,1
WineQualityRed,0.4050000011920929,2.6593096256256104,0.9260015487670898,10000,online,flocet,1
WineQualityWhite,0.42320260405540466,9.418477058410645,4.0495240688323975,10000,online,flocet,1
Yeast,0.3746630847454071,2.3892061710357666,0.8698842525482178,10000,online,flocet,1
Zoo,0.9599999785423279,0.08014965057373047,0.08133316040039062,10000,online,flocet,1
Abalone,0.5804597735404968,6.929339170455933,3.9826128482818604,10000,adjust,flocet,1
AcuteInflammation,1.0,0.2177267074584961,0.09662127494812012,10000,adjust,flocet,1
AcuteNephritis,1.0,0.18542885780334473,0.04822540283203125,10000,adjust,flocet,1
Adult,0.8132178783416748,60.90606188774109,39.347840785980225,10000,adjust,flocet,1
Annealing,0.6499999761581421,1.1750385761260986,0.3732011318206787,10000,adjust,flocet,1
Arrhythmia,0.40707963705062866,0.8716874122619629,0.4961225986480713,10000,adjust,flocet,1
AudiologyStd,0.6399999856948853,0.553666353225708,0.04179072380065918,10000,adjust,flocet,1
BalanceScale,0.8782051205635071,1.4063606262207031,0.24716591835021973,10000,adjust,flocet,1
Balloons,0.75,0.016019582748413086,0.0070343017578125,10000,adjust,flocet,1
Bank,0.8876106142997742,5.205215215682983,2.1099424362182617,10000,adjust,flocet,1
Blood,0.6631016135215759,1.1935338973999023,0.6447024345397949,10000,adjust,flocet,1
BreastCancer,0.7183098793029785,0.6954696178436279,0.11318492889404297,10000,adjust,flocet,1
BreastCancerWisc,0.977142870426178,0.9670958518981934,0.6651430130004883,10000,adjust,flocet,1
BreastCancerWiscDiag,0.9718309640884399,0.9782307147979736,0.2226407527923584,10000,adjust,flocet,1
BreastCancerWiscProg,0.8367347121238708,0.27883362770080566,0.07742428779602051,10000,adjust,flocet,1
BreastTissue,0.807692289352417,0.26967453956604004,0.10050654411315918,10000,adjust,flocet,1
Car,0.8587962985038757,2.3562772274017334,0.6749038696289062,10000,adjust,flocet,1
Cardiotocography10Clases,0.790960431098938,2.758573055267334,0.9690895080566406,10000,adjust,flocet,1
Cardiotocography3Clases,0.8775894641876221,2.837923526763916,1.1407177448272705,10000,adjust,flocet,1
ChessKrvk,0.42999714612960815,37.946157693862915,17.778077125549316,10000,adjust,flocet,1
ChessKrvkp,0.9649562239646912,3.104231357574463,1.6595871448516846,10000,adjust,flocet,1
CongressionalVoting,0.5688073635101318,0.7285275459289551,0.17629528045654297,10000,adjust,flocet,1
ConnBenchSonarMinesRocks,0.8269230723381042,0.4519309997558594,0.2813587188720703,10000,adjust,flocet,1
ConnBenchVowelDeterding,0.8008658289909363,1.1223945617675781,1.4038817882537842,10000,adjust,flocet,1
Connect4,0.7850672006607056,83.92398262023926,37.09107303619385,10000,adjust,flocet,1
Contrac,0.529891312122345,2.5187716484069824,0.5766556262969971,10000,adjust,flocet,1
CreditApproval,0.8139534592628479,0.5715558528900146,0.4507308006286621,10000,adjust,flocet,1
CylinderBands,0.6875,0.7760531902313232,0.5396552085876465,10000,adjust,flocet,1
Dermatology,0.9560439586639404,0.819998025894165,0.23741793632507324,10000,adjust,flocet,1
Echocardiogram,0.8787878751754761,0.3622727394104004,0.17951440811157227,10000,adjust,flocet,1
Ecoli,0.8809523582458496,0.6792819499969482,0.2942965030670166,10000,adjust,flocet,1
EnergyY1,0.9166666865348816,1.3722193241119385,0.5459437370300293,10000,adjust,flocet,1
EnergyY2,0.8697916865348816,1.0171093940734863,0.6738185882568359,10000,adjust,flocet,1
Fertility,0.7599999904632568,0.23852896690368652,0.13691115379333496,10000,adjust,flocet,1
Flags,0.5208333134651184,0.4266936779022217,0.07716178894042969,10000,adjust,flocet,1
Glass,0.2641509473323822,0.46370840072631836,0.2882840633392334,10000,adjust,flocet,1
HabermanSurvival,0.5921052694320679,0.6679172515869141,0.12141108512878418,10000,adjust,flocet,1
HayesRoth,0.75,0.38802337646484375,0.07450151443481445,10000,adjust,flocet,1
HeartCleveland,0.5657894611358643,0.5043935775756836,0.11984992027282715,10000,adjust,flocet,1
HeartHungarian,0.7808219194412231,0.28975701332092285,0.1150047779083252,10000,adjust,flocet,1
HeartSwitzerland,0.4516128897666931,0.23099017143249512,0.050742387771606445,10000,adjust,flocet,1
HeartVa,0.36000001430511475,0.33093714714050293,0.07923626899719238,10000,adjust,flocet,1
Hepatitis,0.8461538553237915,0.16315150260925293,0.11182069778442383,10000,adjust,flocet,1
HillValley,0.4983498454093933,1.2105915546417236,1.0611135959625244,10000,adjust,flocet,1
HorseColic,0.8088235259056091,0.739727258682251,0.14990878105163574,10000,adjust,flocet,1
IlpdIndianLiver,0.698630154132843,0.9625720977783203,0.24167466163635254,10000,adjust,flocet,1
ImageSegmentation,0.8252381086349487,0.48909616470336914,5.7862091064453125,10000,adjust,flocet,1
Ionosphere,0.9545454382896423,0.48044395446777344,0.3558061122894287,10000,adjust,flocet,1
Iris,0.9729729890823364,0.3916487693786621,0.20232081413269043,10000,adjust,flocet,1
LedDisplay,0.656000018119812,0.8882853984832764,0.39089107513427734,10000,adjust,flocet,1
Lenses,0.8333333134651184,0.05265927314758301,0.010636568069458008,10000,adjust,flocet,1
Letter,0.7675999999046326,25.231731176376343,12.445066690444946,10000,adjust,flocet,1
Libras,0.6555555462837219,0.7945096492767334,0.14337396621704102,10000,adjust,flocet,1
LowResSpect,0.8646616339683533,0.767531156539917,0.2093334197998047,10000,adjust,flocet,1
LungCancer,0.375,0.08332967758178711,0.014408349990844727,10000,adjust,flocet,1
Lymphography,0.8648648858070374,0.12624597549438477,0.1985335350036621,10000,adjust,flocet,1
Magic,0.749106228351593,24.087332010269165,11.971818208694458,10000,adjust,flocet,1
Mammographic,0.7833333611488342,1.337557077407837,0.7870352268218994,10000,adjust,flocet,1
Miniboone,0.28441381454467773,167.32619667053223,77.37715768814087,10000,adjust,flocet,1
MolecBiolPromoter,0.8461538553237915,0.31012487411499023,0.08398723602294922,10000,adjust,flocet,1
MolecBiolSplice,0.8230865597724915,3.4726874828338623,2.194706439971924,10000,adjust,flocet,1
Monks1,0.7407407164573669,0.2586669921875,1.3424596786499023,10000,adjust,flocet,1
Monks2,0.9236111044883728,0.23504328727722168,0.9594118595123291,10000,adjust,flocet,1
Monks3,0.9097222089767456,0.4569661617279053,1.2030792236328125,10000,adjust,flocet,1
Mushroom,0.9980305433273315,8.784254550933838,4.608850479125977,10000,adjust,flocet,1
Musk1,0.7058823704719543,0.6647665500640869,0.45232248306274414,10000,adjust,flocet,1
Musk2,0.9593693017959595,8.16879653930664,4.837174415588379,10000,adjust,flocet,1
Nursery,0.9364197254180908,16.09614109992981,8.046938180923462,10000,adjust,flocet,1
OocytesMerlucciusNucleus4d,0.6509804129600525,1.63028883934021,0.44875264167785645,10000,adjust,flocet,1
OocytesMerlucciusStates2f,0.886274516582489,1.5440266132354736,0.9095518589019775,10000,adjust,flocet,1
OocytesTrisopterusNucleus2f,0.7236841917037964,1.3575751781463623,0.5686016082763672,10000,adjust,flocet,1
OocytesTrisopterusStates5b,0.8684210777282715,1.355372428894043,0.5767948627471924,10000,adjust,flocet,1
Optical,0.915971040725708,6.333276033401489,4.238815069198608,10000,adjust,flocet,1
Ozone,0.9731861352920532,3.2243852615356445,1.0625519752502441,10000,adjust,flocet,1
PageBlocks,0.932748556137085,6.854441404342651,3.5691092014312744,10000,adjust,flocet,1
Parkinsons,0.795918345451355,0.15823721885681152,0.07718157768249512,10000,adjust,flocet,1
Pendigits,0.9519725441932678,12.37344241142273,6.20046591758728,10000,adjust,flocet,1
Pima,0.734375,0.7297811508178711,0.44004321098327637,10000,adjust,flocet,1
PittsburgBridgesMaterial,0.8461538553237915,0.26586484909057617,0.06400084495544434,10000,adjust,flocet,1
PittsburgBridgesRelL,0.7307692170143127,0.23629450798034668,0.11324739456176758,10000,adjust,flocet,1
PittsburgBridgesSpan,0.739130437374115,0.11947202682495117,0.036707401275634766,10000,adjust,flocet,1
PittsburgBridgesTOrD,0.7200000286102295,0.19245457649230957,0.11804914474487305,10000,adjust,flocet,1
PittsburgBridgesType,0.5384615659713745,0.2655954360961914,0.1425936222076416,10000,adjust,flocet,1
Planning,0.6666666865348816,0.25104618072509766,0.07127094268798828,10000,adjust,flocet,1
PlantMargin,0.625,2.4299449920654297,1.3182930946350098,10000,adjust,flocet,1
PlantShape,0.29499998688697815,1.840958595275879,1.1661405563354492,10000,adjust,flocet,1
PlantTexture,0.5975000262260437,2.510599136352539,1.0229315757751465,10000,adjust,flocet,1
PostOperative,0.6818181872367859,0.2250511646270752,0.03658914566040039,10000,adjust,flocet,1
PrimaryTumor,0.3658536672592163,0.7110419273376465,0.1335761547088623,10000,adjust,flocet,1
Ringnorm,0.8772972822189331,9.210183382034302,5.284317970275879,10000,adjust,flocet,1
Seeds,0.9038461446762085,0.43308496475219727,0.2502624988555908,10000,adjust,flocet,1
Semeion,0.8542713522911072,2.0149872303009033,1.0731866359710693,10000,adjust,flocet,1
Soybean,0.8563829660415649,0.4624671936035156,0.762181282043457,10000,adjust,flocet,1
Spambase,0.8260869383811951,6.304924964904785,3.089310646057129,10000,adjust,flocet,1
Spect,0.7096773982048035,0.17571520805358887,0.7284717559814453,10000,adjust,flocet,1
Spectf,0.6737967729568481,0.27884459495544434,0.587792158126831,10000,adjust,flocet,1
StatlogAustralianCredit,0.6686046719551086,1.004730463027954,0.4226672649383545,10000,adjust,flocet,1
StatlogGermanCredit,0.7279999852180481,1.525188684463501,0.7677607536315918,10000,adjust,flocet,1
StatlogHeart,0.9104477763175964,0.2714266777038574,0.2761988639831543,10000,adjust,flocet,1
StatlogImage,0.8856152296066284,3.422773599624634,0.9478836059570312,10000,adjust,flocet,1
StatlogLandsat,0.8174999952316284,8.257324457168579,5.79934287071228,10000,adjust,flocet,1
StatlogShuttle,0.6968275904655457,72.21869897842407,36.20464825630188,10000,adjust,flocet,1
StatlogVehicle,0.6255924105644226,0.956533670425415,0.7797884941101074,10000,adjust,flocet,1
SteelPlates,0.6226804256439209,2.7802655696868896,1.2811105251312256,10000,adjust,flocet,1
SyntheticControl,0.9266666769981384,0.9827287197113037,0.23946666717529297,10000,adjust,flocet,1
Teaching,0.6052631735801697,0.24451851844787598,0.06120705604553223,10000,adjust,flocet,1
Thyroid,0.8967328071594238,7.157500982284546,8.587595701217651,10000,adjust,flocet,1
TicTacToe,0.9665272235870361,1.4766957759857178,0.44701623916625977,10000,adjust,flocet,1
Titanic,0.7818182110786438,2.8760015964508057,1.4233427047729492,10000,adjust,flocet,1
Trains,1.0,0.03398537635803223,0.012580633163452148,10000,adjust,flocet,1
Twonorm,0.9627026915550232,9.021484613418579,5.276540517807007,10000,adjust,flocet,1
VertebralColumn2Clases,0.7142857313156128,0.7240540981292725,0.1255955696105957,10000,adjust,flocet,1
VertebralColumn3Clases,0.4545454680919647,0.7209947109222412,0.12120962142944336,10000,adjust,flocet,1
WallFollowing,0.8973606824874878,8.108736038208008,3.478719472885132,10000,adjust,flocet,1
Waveform,0.8672000169754028,6.704902172088623,3.2911598682403564,10000,adjust,flocet,1
WaveformNoise,0.8303999900817871,6.390667200088501,3.979466676712036,10000,adjust,flocet,1
Wine,0.9090909361839294,0.18344521522521973,0.23715972900390625,10000,adjust,flocet,1
WineQualityRed,0.5375000238418579,1.967329978942871,0.6771528720855713,10000,adjust,flocet,1
WineQualityWhite,0.46568626165390015,7.456132650375366,2.8402490615844727,10000,adjust,flocet,1
Yeast,0.5094339847564697,2.322751998901367,1.0282044410705566,10000,adjust,flocet,1
Zoo,1.0,0.17308831214904785,0.050652265548706055,10000,adjust,flocet,1
Abalone,0.5900382995605469,5.116757869720459,2.1763410568237305,5000,adapt,flocet,1
AcuteInflammation,1.0,0.23918676376342773,0.16414761543273926,5000,adapt,flocet,1
AcuteNephritis,1.0,0.24957728385925293,0.1640160083770752,5000,adapt,flocet,1
Adult,0.8366807699203491,47.458792209625244,42.28924059867859,5000,adapt,flocet,1
Annealing,0.7300000190734863,1.2776567935943604,0.15580177307128906,5000,adapt,flocet,1
Arrhythmia,0.0796460211277008,0.7561821937561035,0.17763137817382812,5000,adapt,flocet,1
AudiologyStd,0.5199999809265137,0.4555022716522217,0.041934967041015625,5000,adapt,flocet,1
BalanceScale,0.9166666865348816,0.8504736423492432,0.3022017478942871,5000,adapt,flocet,1
Balloons,0.75,0.018963098526000977,0.020519256591796875,5000,adapt,flocet,1
Bank,0.8840708136558533,6.212397336959839,2.5086889266967773,5000,adapt,flocet,1
Blood,0.7112299203872681,1.03053879737854,0.44161009788513184,5000,adapt,flocet,1
BreastCancer,0.6901408433914185,0.3610684871673584,0.11403298377990723,5000,adapt,flocet,1
BreastCancerWisc,0.9428571462631226,0.8735451698303223,0.3715858459472656,5000,adapt,flocet,1
BreastCancerWiscDiag,0.98591548204422,0.5465619564056396,0.22533488273620605,5000,adapt,flocet,1
BreastCancerWiscProg,0.5102040767669678,0.35081982612609863,0.11959528923034668,5000,adapt,flocet,1
BreastTissue,0.692307710647583,0.10638546943664551,0.041875362396240234,5000,adapt,flocet,1
Car,0.8657407164573669,1.264265775680542,1.105583667755127,5000,adapt,flocet,1
Cardiotocography10Clases,0.6421845555305481,2.2155327796936035,0.8431370258331299,5000,adapt,flocet,1
Cardiotocography3Clases,0.9190207123756409,3.0444817543029785,1.3968214988708496,5000,adapt,flocet,1
ChessKrvk,0.3825206756591797,35.837807416915894,13.276190519332886,5000,adapt,flocet,1
ChessKrvkp,0.9161452054977417,2.899907350540161,2.069446563720703,5000,adapt,flocet,1
CongressionalVoting,0.5688073635101318,0.4655470848083496,0.1696770191192627,5000,adapt,flocet,1
ConnBenchSonarMinesRocks,0.6538461446762085,0.47820496559143066,0.16694903373718262,5000,adapt,flocet,1
ConnBenchVowelDeterding,0.6666666865348816,1.6510310173034668,1.0372087955474854,5000,adapt,flocet,1
Connect4,0.809935450553894,65.39031887054443,39.834285259246826,5000,adapt,flocet,1
Contrac,0.47826087474823,2.7759616374969482,0.570775032043457,5000,adapt,flocet,1
CreditApproval,0.8081395626068115,0.9997134208679199,0.27106308937072754,5000,adapt,flocet,1
CylinderBands,0.625,1.0149879455566406,0.4664895534515381,5000,adapt,flocet,1
Dermatology,0.9780219793319702,0.44332194328308105,0.14221930503845215,5000,adapt,flocet,1
Echocardiogram,0.9090909361839294,0.2840104103088379,0.17987823486328125,5000,adapt,flocet,1
Ecoli,0.8333333134651184,0.7524452209472656,0.3266608715057373,5000,adapt,flocet,1
EnergyY1,0.8333333134651184,1.1344363689422607,0.3003075122833252,5000,adapt,flocet,1
EnergyY2,0.8333333134651184,0.7113220691680908,0.29878926277160645,5000,adapt,flocet,1
Fertility,0.6000000238418579,0.2127835750579834,0.07425951957702637,5000,adapt,flocet,1
Flags,0.4166666567325592,0.41254305839538574,0.2617647647857666,5000,adapt,flocet,1
Glass,0.2641509473323822,0.25385570526123047,0.08319211006164551,5000,adapt,flocet,1
HabermanSurvival,0.6973684430122375,0.4007225036621094,0.12589621543884277,5000,adapt,flocet,1
HayesRoth,0.7857142686843872,0.311398983001709,0.1482400894165039,5000,adapt,flocet,1
HeartCleveland,0.6052631735801697,0.406599760055542,0.12117409706115723,5000,adapt,flocet,1
HeartHungarian,0.7260273694992065,0.6258225440979004,0.38921284675598145,5000,adapt,flocet,1
HeartSwitzerland,0.32258063554763794,0.17788267135620117,0.16713905334472656,5000,adapt,flocet,1
HeartVa,0.1599999964237213,0.387465238571167,0.10193490982055664,5000,adapt,flocet,1
Hepatitis,0.8205128312110901,0.24141931533813477,0.20916509628295898,5000,adapt,flocet,1
HillValley,0.5049505233764648,1.3008613586425781,0.9618337154388428,5000,adapt,flocet,1
HorseColic,0.720588207244873,0.5559093952178955,0.10876727104187012,5000,adapt,flocet,1
IlpdIndianLiver,0.6780821681022644,0.5449600219726562,0.23096513748168945,5000,adapt,flocet,1
ImageSegmentation,0.5899999737739563,0.5283288955688477,3.9520692825317383,5000,adapt,flocet,1
Ionosphere,0.8295454382896423,0.6614718437194824,0.2278916835784912,5000,adapt,flocet,1
Iris,0.9459459185600281,0.3074915409088135,0.2003178596496582,5000,adapt,flocet,1
LedDisplay,0.6159999966621399,1.3471205234527588,0.6478455066680908,5000,adapt,flocet,1
Lenses,0.8333333134651184,0.022780895233154297,0.012545585632324219,5000,adapt,flocet,1
Letter,0.7387999892234802,18.137384176254272,9.01928424835205,5000,adapt,flocet,1
Libras,0.4333333373069763,0.48600125312805176,0.14310216903686523,5000,adapt,flocet,1
LowResSpect,0.8345864415168762,0.9658012390136719,0.4546089172363281,5000,adapt,flocet,1
LungCancer,0.375,0.02910161018371582,0.015286922454833984,5000,adapt,flocet,1
Lymphography,0.7297297120094299,0.3325953483581543,0.2006235122680664,5000,adapt,flocet,1
Magic,0.7762355208396912,17.41429328918457,10.725453853607178,5000,adapt,flocet,1
Mammographic,0.6583333611488342,1.1026980876922607,0.373870849609375,5000,adapt,flocet,1
Miniboone,0.7535674571990967,137.54614925384521,92.01469850540161,5000,adapt,flocet,1
MolecBiolPromoter,0.8846153616905212,0.21874761581420898,0.0673065185546875,5000,adapt,flocet,1
MolecBiolSplice,0.7992472052574158,3.8445653915405273,1.6898672580718994,5000,adapt,flocet,1
Monks1,0.6921296119689941,0.2391369342803955,1.2589869499206543,5000,adapt,flocet,1
Monks2,0.8564814925193787,0.5036211013793945,0.8301877975463867,5000,adapt,flocet,1
Monks3,0.8796296119689941,0.2519991397857666,0.7570898532867432,5000,adapt,flocet,1
Mushroom,1.0,7.964869260787964,5.443936347961426,5000,adapt,flocet,1
Musk1,0.7058823704719543,1.1018187999725342,0.4571516513824463,5000,adapt,flocet,1
Musk2,0.940570056438446,6.569095611572266,3.8104987144470215,5000,adapt,flocet,1
Nursery,0.9095678925514221,12.106827020645142,7.386404275894165,5000,adapt,flocet,1
OocytesMerlucciusNucleus4d,0.4470588266849518,1.7370092868804932,0.39940452575683594,5000,adapt,flocet,1
OocytesMerlucciusStates2f,0.8941176533699036,1.4358007907867432,0.39896368980407715,5000,adapt,flocet,1
OocytesTrisopterusNucleus2f,0.6359649300575256,0.7419254779815674,0.8216876983642578,5000,adapt,flocet,1
OocytesTrisopterusStates5b,0.8026315569877625,1.1993122100830078,0.42302775382995605,5000,adapt,flocet,1
Optical,0.9287701845169067,6.489246606826782,4.147756099700928,5000,adapt,flocet,1
Ozone,0.9731861352920532,3.827467918395996,1.5570309162139893,5000,adapt,flocet,1
PageBlocks,0.8698830604553223,6.229884386062622,2.586670160293579,5000,adapt,flocet,1
Parkinsons,0.8979591727256775,0.41439270973205566,0.26590538024902344,5000,adapt,flocet,1
Pendigits,0.9253859519958496,9.007452964782715,6.622334241867065,5000,adapt,flocet,1
Pima,0.7395833134651184,1.1439237594604492,1.033867597579956,5000,adapt,flocet,1
PittsburgBridgesMaterial,0.8461538553237915,0.23943638801574707,0.05552482604980469,5000,adapt,flocet,1
PittsburgBridgesRelL,0.6153846383094788,0.23981904983520508,0.13162803649902344,5000,adapt,flocet,1
PittsburgBridgesSpan,0.695652186870575,0.09571957588195801,0.11819720268249512,5000,adapt,flocet,1
PittsburgBridgesTOrD,0.7599999904632568,0.09592270851135254,0.13373613357543945,5000,adapt,flocet,1
PittsburgBridgesType,0.42307692766189575,0.14469075202941895,0.14099860191345215,5000,adapt,flocet,1
Planning,0.7111111283302307,0.4395582675933838,0.0752866268157959,5000,adapt,flocet,1
PlantMargin,0.39750000834465027,1.833531379699707,1.0118541717529297,5000,adapt,flocet,1
PlantShape,0.11249999701976776,2.4260997772216797,0.9398763179779053,5000,adapt,flocet,1
PlantTexture,0.2150000035762787,2.5214638710021973,1.2274436950683594,5000,adapt,flocet,1
PostOperative,0.5,0.20151185989379883,0.1202249526977539,5000,adapt,flocet,1
PrimaryTumor,0.32926830649375916,0.7785501480102539,0.40428829193115234,5000,adapt,flocet,1
Ringnorm,0.9167567491531372,7.45457124710083,3.6958346366882324,5000,adapt,flocet,1
Seeds,0.8846153616905212,0.3955862522125244,0.16412806510925293,5000,adapt,flocet,1
Semeion,0.8618090748786926,2.2075741291046143,0.6240348815917969,5000,adapt,flocet,1
Soybean,0.813829779624939,0.900580883026123,0.5897126197814941,5000,adapt,flocet,1
Spambase,0.8660869598388672,6.0168297290802,3.5744664669036865,5000,adapt,flocet,1
Spect,0.6344085931777954,0.14344263076782227,0.291795015335083,5000,adapt,flocet,1
Spectf,0.9197860956192017,0.24677562713623047,0.8634748458862305,5000,adapt,flocet,1
StatlogAustralianCredit,0.6976743936538696,1.631490707397461,0.5629220008850098,5000,adapt,flocet,1
StatlogGermanCredit,0.6919999718666077,1.6290233135223389,0.39003777503967285,5000,adapt,flocet,1
StatlogHeart,0.6865671873092651,0.620868444442749,0.36322522163391113,5000,adapt,flocet,1
StatlogImage,0.9185441732406616,2.489802360534668,0.8990821838378906,5000,adapt,flocet,1
StatlogLandsat,0.8805000185966492,7.841272354125977,3.7372639179229736,5000,adapt,flocet,1
StatlogShuttle,0.8040689826011658,54.575430154800415,30.276594161987305,5000,adapt,flocet,1
StatlogVehicle,0.5971564054489136,0.7876429557800293,0.40595149993896484,5000,adapt,flocet,1
SteelPlates,0.5835051536560059,2.4318761825561523,1.083822250366211,5000,adapt,flocet,1
SyntheticControl,0.9599999785423279,0.6026961803436279,0.23439764976501465,5000,adapt,flocet,1
Teaching,0.42105263471603394,0.21304917335510254,0.17730927467346191,5000,adapt,flocet,1
Thyroid,0.9355309009552002,4.77015495300293,7.379154920578003,5000,adapt,flocet,1
TicTacToe,0.8953974843025208,1.0034396648406982,0.3727602958679199,5000,adapt,flocet,1
Titanic,0.7599999904632568,2.4163477420806885,1.4370810985565186,5000,adapt,flocet,1
Trains,1.0,0.017921924591064453,0.012456417083740234,5000,adapt,flocet,1
Twonorm,0.8870270252227783,9.362099409103394,4.666670799255371,5000,adapt,flocet,1
VertebralColumn2Clases,0.7532467246055603,0.6423649787902832,0.31914830207824707,5000,adapt,flocet,1
VertebralColumn3Clases,0.41558441519737244,0.7206599712371826,0.23856306076049805,5000,adapt,flocet,1
WallFollowing,0.8973606824874878,5.594283580780029,2.8761730194091797,5000,adapt,flocet,1
Waveform,0.8416000008583069,5.326011896133423,2.4128220081329346,5000,adapt,flocet,1
WaveformNoise,0.8256000280380249,4.335204601287842,2.3736541271209717,5000,adapt,flocet,1
Wine,1.0,0.3779284954071045,0.17466354370117188,5000,adapt,flocet,1
WineQualityRed,0.5,2.6000776290893555,1.1644768714904785,5000,adapt,flocet,1
WineQualityWhite,0.4395424723625183,6.1293065547943115,2.6866116523742676,5000,adapt,flocet,1
Yeast,0.40161725878715515,1.2457270622253418,0.9306514263153076,5000,adapt,flocet,1
Zoo,0.8799999952316284,0.09081125259399414,0.0887446403503418,5000,adapt,flocet,1
Abalone,0.5134099721908569,4.351020812988281,1.9135775566101074,5000,online,flocet,1
AcuteInflammation,1.0,0.23872947692871094,0.050504446029663086,5000,online,flocet,1
AcuteNephritis,1.0,0.1453533172607422,0.16091561317443848,5000,online,flocet,1
Adult,0.7941158413887024,50.71678018569946,37.65083885192871,5000,online,flocet,1
Annealing,0.8399999737739563,1.5711042881011963,0.18487787246704102,5000,online,flocet,1
Arrhythmia,0.12389380484819412,0.7729160785675049,0.45095086097717285,5000,online,flocet,1
AudiologyStd,0.8799999952316284,0.43282413482666016,0.12682390213012695,5000,online,flocet,1
BalanceScale,0.9102563858032227,1.3348441123962402,0.4978344440460205,5000,online,flocet,1
Balloons,0.75,0.019934892654418945,0.02236199378967285,5000,online,flocet,1
Bank,0.8495575189590454,4.406953811645508,2.2928519248962402,5000,online,flocet,1
Blood,0.6684492230415344,1.308480978012085,0.29032373428344727,5000,online,flocet,1
BreastCancer,0.591549277305603,0.5306322574615479,0.23433232307434082,5000,online,flocet,1
BreastCancerWisc,0.9371428489685059,0.56374192237854,0.5551114082336426,5000,online,flocet,1
BreastCancerWiscDiag,0.9366196990013123,1.1676599979400635,0.38047313690185547,5000,online,flocet,1
BreastCancerWiscProg,0.7755101919174194,0.38628649711608887,0.12378811836242676,5000,online,flocet,1
BreastTissue,0.692307710647583,0.2655315399169922,0.14271068572998047,5000,online,flocet,1
Car,0.8217592835426331,2.823070526123047,0.9797031879425049,5000,online,flocet,1
Cardiotocography10Clases,0.7193973660469055,2.7255074977874756,0.8270635604858398,5000,online,flocet,1
Cardiotocography3Clases,0.9020715355873108,1.8835175037384033,2.15553617477417,5000,online,flocet,1
ChessKrvk,0.4157399535179138,42.69996476173401,19.238739728927612,5000,online,flocet,1
ChessKrvkp,0.8836045265197754,4.261002540588379,1.420304536819458,5000,online,flocet,1
CongressionalVoting,0.5871559381484985,1.0410842895507812,0.17152643203735352,5000,online,flocet,1
ConnBenchSonarMinesRocks,0.7115384340286255,0.3355565071105957,0.08605170249938965,5000,online,flocet,1
ConnBenchVowelDeterding,0.7748917937278748,1.4606738090515137,2.0361926555633545,5000,online,flocet,1
Connect4,0.8078038692474365,84.9208152294159,39.42344665527344,5000,online,flocet,1
Contrac,0.4375,1.5367369651794434,1.2490947246551514,5000,online,flocet,1
CreditApproval,0.819767415523529,1.0385067462921143,0.5318100452423096,5000,online,flocet,1
CylinderBands,0.6953125,1.2149217128753662,0.4231884479522705,5000,online,flocet,1
Dermatology,0.8791208863258362,0.8074522018432617,0.14603781700134277,5000,online,flocet,1
Echocardiogram,0.7575757503509521,0.29696106910705566,0.17803597450256348,5000,online,flocet,1
Ecoli,0.8690476417541504,0.37179040908813477,0.13107633590698242,5000,online,flocet,1
EnergyY1,0.8645833134651184,1.5130302906036377,0.42453479766845703,5000,online,flocet,1
EnergyY2,0.8541666865348816,1.150986909866333,0.6264364719390869,5000,online,flocet,1
Fertility,0.8799999952316284,0.20917153358459473,0.13454771041870117,5000,online,flocet,1
Flags,0.5625,0.467426061630249,0.25776028633117676,5000,online,flocet,1
Glass,0.2830188572406769,0.5311896800994873,0.0858469009399414,5000,online,flocet,1
HabermanSurvival,0.5921052694320679,0.6925382614135742,0.4077908992767334,5000,online,flocet,1
HayesRoth,0.6785714030265808,0.4438045024871826,0.15071511268615723,5000,online,flocet,1
HeartCleveland,0.4736842215061188,0.37012195587158203,0.11896920204162598,5000,online,flocet,1
HeartHungarian,0.6849315166473389,0.7035441398620605,0.39115405082702637,5000,online,flocet,1
HeartSwitzerland,0.32258063554763794,0.2186121940612793,0.049285888671875,5000,online,flocet,1
HeartVa,0.3199999928474426,0.24419784545898438,0.07843971252441406,5000,online,flocet,1
Hepatitis,0.7948718070983887,0.32225871086120605,0.16682720184326172,5000,online,flocet,1
HillValley,0.5214521288871765,1.2483210563659668,1.4361598491668701,5000,online,flocet,1
HorseColic,0.7647058963775635,0.49484896659851074,0.10555458068847656,5000,online,flocet,1
IlpdIndianLiver,0.7054794430732727,1.263521432876587,0.22579550743103027,5000,online,flocet,1
ImageSegmentation,0.715238094329834,0.5921511650085449,6.023985862731934,5000,online,flocet,1
Ionosphere,0.9545454382896423,0.796379804611206,0.4718618392944336,5000,online,flocet,1
Iris,0.9729729890823364,0.2512364387512207,0.19828295707702637,5000,online,flocet,1
LedDisplay,0.7200000286102295,1.130490779876709,0.46582937240600586,5000,online,flocet,1
Lenses,0.8333333134651184,0.025138378143310547,0.01246953010559082,5000,online,flocet,1
Letter,0.8083999752998352,19.821670055389404,9.936010122299194,5000,online,flocet,1
Libras,0.5,0.8191440105438232,0.4454522132873535,5000,online,flocet,1
LowResSpect,0.3308270573616028,0.5407495498657227,0.20800209045410156,5000,online,flocet,1
LungCancer,0.5,0.032858848571777344,0.01530313491821289,5000,online,flocet,1
Lymphography,0.9459459185600281,0.35036778450012207,0.19867277145385742,5000,online,flocet,1
Magic,0.6862249970436096,17.192995071411133,9.1936674118042,5000,online,flocet,1
Mammographic,0.7083333134651184,0.736018180847168,0.47702789306640625,5000,online,flocet,1
Miniboone,0.28444457054138184,125.64921355247498,87.41360020637512,5000,online,flocet,1
MolecBiolPromoter,0.9615384340286255,0.1944139003753662,0.059920310974121094,5000,online,flocet,1
MolecBiolSplice,0.7314931154251099,4.348688840866089,2.0193862915039062,5000,online,flocet,1
Monks1,0.7314814925193787,0.20171213150024414,1.0338962078094482,5000,online,flocet,1
Monks2,0.8842592835426331,0.316694974899292,0.870995283126831,5000,online,flocet,1
Monks3,0.8287037014961243,0.36674022674560547,1.3962883949279785,5000,online,flocet,1
Mushroom,0.9985228776931763,8.593839645385742,5.400329351425171,5000,online,flocet,1
Musk1,0.5378151535987854,1.020700216293335,0.18698573112487793,5000,online,flocet,1
Musk2,0.9205579161643982,6.592063903808594,3.403949499130249,5000,online,flocet,1
Nursery,0.934567928314209,13.543043613433838,8.213757514953613,5000,online,flocet,1
OocytesMerlucciusNucleus4d,0.6823529601097107,2.075589895248413,0.40024280548095703,5000,online,flocet,1
OocytesMerlucciusStates2f,0.8549019694328308,1.1250267028808594,0.39741039276123047,5000,online,flocet,1
OocytesTrisopterusNucleus2f,0.6359649300575256,1.203005313873291,0.3554840087890625,5000,online,flocet,1
OocytesTrisopterusStates5b,0.8684210777282715,1.3643791675567627,0.7018675804138184,5000,online,flocet,1
Optical,0.9271007180213928,5.300628423690796,4.860259532928467,5000,online,flocet,1
Ozone,0.9684542417526245,3.2656028270721436,1.5025160312652588,5000,online,flocet,1
PageBlocks,0.8676900863647461,6.999488353729248,3.7510273456573486,5000,online,flocet,1
Parkinsons,0.8775510191917419,0.41237425804138184,0.2633507251739502,5000,online,flocet,1
Pendigits,0.9408233165740967,9.790422439575195,7.108915090560913,5000,online,flocet,1
Pima,0.71875,1.476926565170288,0.29805445671081543,5000,online,flocet,1
PittsburgBridgesMaterial,0.807692289352417,0.12688064575195312,0.1061546802520752,5000,online,flocet,1
PittsburgBridgesRelL,0.6538461446762085,0.24991703033447266,0.14150619506835938,5000,online,flocet,1
PittsburgBridgesSpan,0.52173912525177,0.2178034782409668,0.042948246002197266,5000,online,flocet,1
PittsburgBridgesTOrD,0.6000000238418579,0.10461139678955078,0.13541316986083984,5000,online,flocet,1
PittsburgBridgesType,0.42307692766189575,0.17634963989257812,0.14089083671569824,5000,online,flocet,1
Planning,0.644444465637207,0.31914258003234863,0.10409712791442871,5000,online,flocet,1
PlantMargin,0.5099999904632568,1.8031868934631348,0.7249755859375,5000,online,flocet,1
PlantShape,0.26750001311302185,2.361260175704956,0.6303298473358154,5000,online,flocet,1
PlantTexture,0.5400000214576721,1.5921390056610107,0.6225125789642334,5000,online,flocet,1
PostOperative,0.3636363744735718,0.1167604923248291,0.11948728561401367,5000,online,flocet,1
PrimaryTumor,0.2926829159259796,0.5994613170623779,0.15377593040466309,5000,online,flocet,1
Ringnorm,0.9270270466804504,7.103564023971558,3.8599493503570557,5000,online,flocet,1
Seeds,0.8846153616905212,0.3447854518890381,0.08220553398132324,5000,online,flocet,1
Semeion,0.8592965006828308,1.2721571922302246,0.9121899604797363,5000,online,flocet,1
Soybean,0.8005319237709045,0.6271233558654785,1.2319581508636475,5000,online,flocet,1
Spambase,0.7730434536933899,5.300315856933594,2.0760269165039062,5000,online,flocet,1
Spect,0.5,0.2557358741760254,0.36403918266296387,5000,online,flocet,1
Spectf,0.2032085508108139,0.2438218593597412,0.73177170753479,5000,online,flocet,1
StatlogAustralianCredit,0.6104651093482971,0.6884250640869141,0.2674274444580078,5000,online,flocet,1
StatlogGermanCredit,0.7160000205039978,1.8408410549163818,0.38913846015930176,5000,online,flocet,1
StatlogHeart,0.7313432693481445,0.5964040756225586,0.3604748249053955,5000,online,flocet,1
StatlogImage,0.9202772974967957,2.645953893661499,1.4055583477020264,5000,online,flocet,1
StatlogLandsat,0.8019999861717224,5.506036758422852,4.78658390045166,5000,online,flocet,1
StatlogShuttle,0.20882758498191833,57.03202176094055,37.157550573349,5000,online,flocet,1
StatlogVehicle,0.6113743782043457,1.459320068359375,0.5167236328125,5000,online,flocet,1
SteelPlates,0.6432989835739136,1.8961057662963867,0.7522578239440918,5000,online,flocet,1
SyntheticControl,0.9733333587646484,0.6818430423736572,0.2347259521484375,5000,online,flocet,1
Teaching,0.5263158082962036,0.38635969161987305,0.06297850608825684,5000,online,flocet,1
Thyroid,0.9477829933166504,5.02151894569397,6.888789415359497,5000,online,flocet,1
TicTacToe,0.9246861934661865,1.2652950286865234,0.6153402328491211,5000,online,flocet,1
Titanic,0.7054545283317566,2.7673017978668213,0.9596421718597412,5000,online,flocet,1
Trains,0.5,0.01654052734375,0.006967782974243164,5000,online,flocet,1
Twonorm,0.9551351070404053,6.973984003067017,3.236874580383301,5000,online,flocet,1
VertebralColumn2Clases,0.7532467246055603,0.5105679035186768,0.18291640281677246,5000,online,flocet,1
VertebralColumn3Clases,0.3896103799343109,0.6894235610961914,0.12261819839477539,5000,online,flocet,1
WallFollowing,0.9171554446220398,4.9120941162109375,2.688053607940674,5000,online,flocet,1
Waveform,0.8191999793052673,5.090434312820435,2.270721673965454,5000,online,flocet,1
WaveformNoise,0.8471999764442444,4.715980529785156,2.4847660064697266,5000,online,flocet,1
Wine,0.9545454382896423,0.2765207290649414,0.06930422782897949,5000,online,flocet,1
WineQualityRed,0.4625000059604645,2.1332268714904785,1.1557254791259766,5000,online,flocet,1
WineQualityWhite,0.42401960492134094,6.168050765991211,2.689467191696167,5000,online,flocet,1
Yeast,0.46900269389152527,2.220693826675415,0.8012206554412842,5000,online,flocet,1
Zoo,0.8399999737739563,0.16723251342773438,0.13594388961791992,5000,online,flocet,1
Abalone,0.5909961462020874,6.216888904571533,2.017489194869995,5000,adjust,flocet,1
AcuteInflammation,1.0,0.291090726852417,0.1625347137451172,5000,adjust,flocet,1
AcuteNephritis,1.0,0.1929309368133545,0.048345088958740234,5000,adjust,flocet,1
Adult,0.8127878904342651,54.38828444480896,31.451282501220703,5000,adjust,flocet,1
Annealing,0.6800000071525574,1.3728463649749756,0.15537476539611816,5000,adjust,flocet,1
Arrhythmia,0.44247788190841675,1.2282681465148926,0.6072909832000732,5000,adjust,flocet,1
AudiologyStd,0.5600000023841858,0.294081449508667,0.03967142105102539,5000,adjust,flocet,1
BalanceScale,0.9102563858032227,0.9910619258880615,0.2440805435180664,5000,adjust,flocet,1
Balloons,0.75,0.03328537940979004,0.02304530143737793,5000,adjust,flocet,1
Bank,0.8707964420318604,6.115504026412964,2.616809606552124,5000,adjust,flocet,1
Blood,0.6844919919967651,1.3215253353118896,0.2906510829925537,5000,adjust,flocet,1
BreastCancer,0.6338028311729431,0.6193711757659912,0.25827741622924805,5000,adjust,flocet,1
BreastCancerWisc,0.9828571677207947,1.050313949584961,0.2730400562286377,5000,adjust,flocet,1
BreastCancerWiscDiag,0.9718309640884399,1.0265178680419922,0.41459107398986816,5000,adjust,flocet,1
BreastCancerWiscProg,0.8163265585899353,0.5313248634338379,0.2254624366760254,5000,adjust,flocet,1
BreastTissue,0.692307710647583,0.23851633071899414,0.14103102684020996,5000,adjust,flocet,1
Car,0.9189814925193787,2.2390177249908447,0.6717827320098877,5000,adjust,flocet,1
Cardiotocography10Clases,0.7024481892585754,3.7374179363250732,1.1164789199829102,5000,adjust,flocet,1
Cardiotocography3Clases,0.8700565099716187,2.550882339477539,0.8208258152008057,5000,adjust,flocet,1
ChessKrvk,0.41873395442962646,42.5987389087677,17.023831605911255,5000,adjust,flocet,1
ChessKrvkp,0.96620774269104,3.7508325576782227,2.2456982135772705,5000,adjust,flocet,1
CongressionalVoting,0.642201840877533,0.7318239212036133,0.4395756721496582,5000,adjust,flocet,1
ConnBenchSonarMinesRocks,0.7115384340286255,0.4727213382720947,0.28022313117980957,5000,adjust,flocet,1
ConnBenchVowelDeterding,0.7835497856140137,1.1689534187316895,0.9453513622283936,5000,adjust,flocet,1
Connect4,0.7690804600715637,100.51907396316528,39.34797430038452,5000,adjust,flocet,1
Contrac,0.4646739065647125,2.0408332347869873,0.7665235996246338,5000,adjust,flocet,1
CreditApproval,0.7441860437393188,0.9799354076385498,0.2678205966949463,5000,adjust,flocet,1
CylinderBands,0.6953125,0.7615399360656738,0.2785465717315674,5000,adjust,flocet,1
Dermatology,0.9780219793319702,0.4134683609008789,0.48918914794921875,5000,adjust,flocet,1
Echocardiogram,0.8484848737716675,0.26025843620300293,0.12546801567077637,5000,adjust,flocet,1
Ecoli,0.8333333134651184,0.5895423889160156,0.13143062591552734,5000,adjust,flocet,1
EnergyY1,0.875,0.6553220748901367,0.4456920623779297,5000,adjust,flocet,1
EnergyY2,0.8177083134651184,1.1675047874450684,0.29796576499938965,5000,adjust,flocet,1
Fertility,0.8799999952316284,0.2175135612487793,0.11438679695129395,5000,adjust,flocet,1
Flags,0.5208333134651184,0.4682319164276123,0.2585420608520508,5000,adjust,flocet,1
Glass,0.2830188572406769,0.2889251708984375,0.08262109756469727,5000,adjust,flocet,1
HabermanSurvival,0.6578947305679321,0.3727560043334961,0.19299697875976562,5000,adjust,flocet,1
HayesRoth,0.7142857313156128,0.18792414665222168,0.0443425178527832,5000,adjust,flocet,1
HeartCleveland,0.6052631735801697,0.6629583835601807,0.12017059326171875,5000,adjust,flocet,1
HeartHungarian,0.8082191944122314,0.7236096858978271,0.2654879093170166,5000,adjust,flocet,1
HeartSwitzerland,0.29032257199287415,0.36606383323669434,0.07085227966308594,5000,adjust,flocet,1
HeartVa,0.23999999463558197,0.3755660057067871,0.07827425003051758,5000,adjust,flocet,1
Hepatitis,0.8717948794364929,0.2847926616668701,0.06200528144836426,5000,adjust,flocet,1
HillValley,0.5016501545906067,1.1478209495544434,1.2473371028900146,5000,adjust,flocet,1
HorseColic,0.7941176295280457,0.657029390335083,0.21424579620361328,5000,adjust,flocet,1
IlpdIndianLiver,0.6780821681022644,1.0647928714752197,0.2261829376220703,5000,adjust,flocet,1
ImageSegmentation,0.8561905026435852,0.46659326553344727,4.755456447601318,5000,adjust,flocet,1
Ionosphere,0.9204545617103577,0.4025552272796631,0.13739991188049316,5000,adjust,flocet,1
Iris,0.9729729890823364,0.3883402347564697,0.06465888023376465,5000,adjust,flocet,1
LedDisplay,0.7319999933242798,1.5027005672454834,0.6055693626403809,5000,adjust,flocet,1
Lenses,0.6666666865348816,0.053115129470825195,0.03398489952087402,5000,adjust,flocet,1
Letter,0.7675999999046326,23.700245141983032,11.294596195220947,5000,adjust,flocet,1
Libras,0.5333333611488342,0.5570070743560791,0.14086461067199707,5000,adjust,flocet,1
LowResSpect,0.8270676732063293,0.8074753284454346,0.6437563896179199,5000,adjust,flocet,1
LungCancer,0.375,0.04370427131652832,0.020508289337158203,5000,adjust,flocet,1
Lymphography,0.8648648858070374,0.3719184398651123,0.19925189018249512,5000,adjust,flocet,1
Magic,0.7629863023757935,21.244277000427246,10.031858921051025,5000,adjust,flocet,1
Mammographic,0.75,1.2186951637268066,0.6296582221984863,5000,adjust,flocet,1
Miniboone,0.28444457054138184,143.78019213676453,85.8090832233429,5000,adjust,flocet,1
MolecBiolPromoter,0.9230769276618958,0.187333345413208,0.042119503021240234,5000,adjust,flocet,1
MolecBiolSplice,0.7691342830657959,5.427523374557495,1.9322922229766846,5000,adjust,flocet,1
Monks1,0.6898148059844971,0.34162068367004395,1.501877784729004,5000,adjust,flocet,1
Monks2,0.9004629850387573,0.6002545356750488,1.2431576251983643,5000,adjust,flocet,1
Monks3,0.9027777910232544,0.4266090393066406,1.5405068397521973,5000,adjust,flocet,1
Mushroom,0.9990152716636658,9.758026123046875,5.718255281448364,5000,adjust,flocet,1
Musk1,0.6134454011917114,0.4617118835449219,0.4487159252166748,5000,adjust,flocet,1
Musk2,0.9484536051750183,7.960777282714844,5.019487142562866,5000,adjust,flocet,1
Nursery,0.9327160716056824,15.92671537399292,7.843469142913818,5000,adjust,flocet,1
OocytesMerlucciusNucleus4d,0.6823529601097107,1.850269079208374,0.3988182544708252,5000,adjust,flocet,1
OocytesMerlucciusStates2f,0.8705882430076599,1.4716811180114746,0.3964273929595947,5000,adjust,flocet,1
OocytesTrisopterusNucleus2f,0.75,1.3791019916534424,0.35442376136779785,5000,adjust,flocet,1
OocytesTrisopterusStates5b,0.8201754093170166,1.318213939666748,0.6676559448242188,5000,adjust,flocet,1
Optical,0.9426822662353516,5.828190326690674,3.986394166946411,5000,adjust,flocet,1
Ozone,0.9495267868041992,3.4771788120269775,1.7439746856689453,5000,adjust,flocet,1
PageBlocks,0.9320175647735596,6.303181886672974,3.4825663566589355,5000,adjust,flocet,1
Parkinsons,0.8163265585899353,0.307283878326416,0.07674908638000488,5000,adjust,flocet,1
Pendigits,0.9313893914222717,11.362778902053833,8.685012817382812,5000,adjust,flocet,1
Pima,0.7291666865348816,1.268151044845581,0.550013542175293,5000,adjust,flocet,1
PittsburgBridgesMaterial,0.8461538553237915,0.2398548126220703,0.1430966854095459,5000,adjust,flocet,1
PittsburgBridgesRelL,0.7307692170143127,0.26212167739868164,0.04390311241149902,5000,adjust,flocet,1
PittsburgBridgesSpan,0.6521739363670349,0.14914894104003906,0.11447310447692871,5000,adjust,flocet,1
PittsburgBridgesTOrD,0.8399999737739563,0.24011588096618652,0.13541722297668457,5000,adjust,flocet,1
PittsburgBridgesType,0.3461538553237915,0.13482379913330078,0.04116487503051758,5000,adjust,flocet,1
Planning,0.644444465637207,0.48701047897338867,0.2420501708984375,5000,adjust,flocet,1
PlantMargin,0.5475000143051147,2.361647129058838,0.8127822875976562,5000,adjust,flocet,1
PlantShape,0.26499998569488525,2.4431514739990234,1.2965967655181885,5000,adjust,flocet,1
PlantTexture,0.5874999761581421,2.372154712677002,1.135901927947998,5000,adjust,flocet,1
PostOperative,0.5454545617103577,0.16246390342712402,0.04662299156188965,5000,adjust,flocet,1
PrimaryTumor,0.32926830649375916,0.9076285362243652,0.13075661659240723,5000,adjust,flocet,1
Ringnorm,0.9118918776512146,8.208301305770874,4.415209531784058,5000,adjust,flocet,1
Seeds,0.9038461446762085,0.25232672691345215,0.0814981460571289,5000,adjust,flocet,1
Semeion,0.9045225977897644,1.6938197612762451,0.8607492446899414,5000,adjust,flocet,1
Soybean,0.8244680762290955,0.8022861480712891,0.5859322547912598,5000,adjust,flocet,1
Spambase,0.8269565105438232,5.770356893539429,2.6921908855438232,5000,adjust,flocet,1
Spect,0.6827957034111023,0.2540414333343506,0.5317609310150146,5000,adjust,flocet,1
Spectf,0.3743315637111664,0.19800806045532227,0.4815192222595215,5000,adjust,flocet,1
StatlogAustralianCredit,0.5988371968269348,0.9854156970977783,0.37688183784484863,5000,adjust,flocet,1
StatlogGermanCredit,0.7279999852180481,1.405667781829834,0.44072890281677246,5000,adjust,flocet,1
StatlogHeart,0.8507462739944458,0.6330034732818604,0.10593175888061523,5000,adjust,flocet,1
StatlogImage,0.8925476670265198,3.0164103507995605,1.828913927078247,5000,adjust,flocet,1
StatlogLandsat,0.8345000147819519,7.063740015029907,4.999974489212036,5000,adjust,flocet,1
StatlogShuttle,0.704137921333313,65.29483604431152,31.283618211746216,5000,adjust,flocet,1
StatlogVehicle,0.4881516695022583,0.8817722797393799,0.33165740966796875,5000,adjust,flocet,1
SteelPlates,0.6721649765968323,2.23701548576355,1.329174280166626,5000,adjust,flocet,1
SyntheticControl,0.8933333158493042,0.5016028881072998,0.3479797840118408,5000,adjust,flocet,1
Teaching,0.44736841320991516,0.2270069122314453,0.05982565879821777,5000,adjust,flocet,1
Thyroid,0.876604437828064,5.30281662940979,6.988319158554077,5000,adjust,flocet,1
TicTacToe,0.9790794849395752,0.8634583950042725,0.5114631652832031,5000,adjust,flocet,1
Titanic,0.7818182110786438,2.67409610748291,1.2545857429504395,5000,adjust,flocet,1
Trains,0.5,0.023158550262451172,0.011128664016723633,5000,adjust,flocet,1
Twonorm,0.9437837600708008,7.193712472915649,4.046710968017578,5000,adjust,flocet,1
VertebralColumn2Clases,0.7662337422370911,0.3549990653991699,0.29254627227783203,5000,adjust,flocet,1
VertebralColumn3Clases,0.5584415793418884,0.5638082027435303,0.11976194381713867,5000,adjust,flocet,1
WallFollowing,0.912756621837616,6.106875896453857,2.690075635910034,5000,adjust,flocet,1
Waveform,0.8511999845504761,5.437479019165039,2.9770798683166504,5000,adjust,flocet,1
WaveformNoise,0.8360000252723694,6.791074514389038,3.3782553672790527,5000,adjust,flocet,1
Wine,0.9545454382896423,0.3265559673309326,0.23813629150390625,5000,adjust,flocet,1
WineQualityRed,0.47999998927116394,3.4329304695129395,1.0998735427856445,5000,adjust,flocet,1
WineQualityWhite,0.4452614486217499,7.288569688796997,3.439222574234009,5000,adjust,flocet,1
Yeast,0.5229110717773438,2.207486629486084,0.8378560543060303,5000,adjust,flocet,1
Zoo,0.8399999737739563,0.24936795234680176,0.13582825660705566,5000,adjust,flocet,1
Abalone,0.5498084425926208,4.540954828262329,2.389364004135132,1000,adapt,flocet,1
AcuteInflammation,1.0,0.23035621643066406,0.050106048583984375,1000,adapt,flocet,1
AcuteNephritis,1.0,0.13086986541748047,0.047881126403808594,1000,adapt,flocet,1
Adult,0.7908605337142944,42.86798429489136,35.53995990753174,1000,adapt,flocet,1
Annealing,0.6600000262260437,0.9264731407165527,0.3072388172149658,1000,adapt,flocet,1
Arrhythmia,0.1946902722120285,0.36841392517089844,0.17667222023010254,1000,adapt,flocet,1
AudiologyStd,0.6399999856948853,0.39338111877441406,0.04016733169555664,1000,adapt,flocet,1
BalanceScale,0.8461538553237915,0.97525954246521,0.24183106422424316,1000,adapt,flocet,1
Balloons,0.75,0.025912046432495117,0.012697458267211914,1000,adapt,flocet,1
Bank,0.8814159035682678,4.756883859634399,2.544924259185791,1000,adapt,flocet,1
Blood,0.7486631274223328,0.6861340999603271,0.2907900810241699,1000,adapt,flocet,1
BreastCancer,0.49295774102211,0.3689596652984619,0.11141276359558105,1000,adapt,flocet,1
BreastCancerWisc,0.9657142758369446,0.8471970558166504,0.38840627670288086,1000,adapt,flocet,1
BreastCancerWiscDiag,0.9718309640884399,0.5172030925750732,0.41527295112609863,1000,adapt,flocet,1
BreastCancerWiscProg,0.6734693646430969,0.3813486099243164,0.0791163444519043,1000,adapt,flocet,1
BreastTissue,0.7307692170143127,0.0945279598236084,0.04096484184265137,1000,adapt,flocet,1
Car,0.8680555820465088,2.075850248336792,0.9357056617736816,1000,adapt,flocet,1
Cardiotocography10Clases,0.7043314576148987,2.5223653316497803,1.0123817920684814,1000,adapt,flocet,1
Cardiotocography3Clases,0.8286252617835999,1.954948902130127,1.4374444484710693,1000,adapt,flocet,1
ChessKrvk,0.37311092019081116,36.18110990524292,18.761821746826172,1000,adapt,flocet,1
ChessKrvkp,0.9424280524253845,3.7182869911193848,1.397632122039795,1000,adapt,flocet,1
CongressionalVoting,0.6238532066345215,0.6516368389129639,0.296886682510376,1000,adapt,flocet,1
ConnBenchSonarMinesRocks,0.75,0.46785688400268555,0.12041425704956055,1000,adapt,flocet,1
ConnBenchVowelDeterding,0.6515151262283325,0.5584843158721924,1.4094586372375488,1000,adapt,flocet,1
Connect4,0.6474036574363708,85.21914386749268,44.69467282295227,1000,adapt,flocet,1
Contrac,0.448369562625885,1.3874924182891846,0.8553860187530518,1000,adapt,flocet,1
CreditApproval,0.8313953280448914,0.9038786888122559,0.26795244216918945,1000,adapt,flocet,1
CylinderBands,0.703125,0.6524522304534912,0.19913768768310547,1000,adapt,flocet,1
Dermatology,0.9670329689979553,0.6348028182983398,0.1416313648223877,1000,adapt,flocet,1
Echocardiogram,0.8787878751754761,0.2668299674987793,0.17975783348083496,1000,adapt,flocet,1
Ecoli,0.8571428656578064,0.4291799068450928,0.1311037540435791,1000,adapt,flocet,1
EnergyY1,0.90625,0.8771700859069824,0.2982625961303711,1000,adapt,flocet,1
EnergyY2,0.8697916865348816,0.8757729530334473,0.6347320079803467,1000,adapt,flocet,1
Fertility,0.8399999737739563,0.1117103099822998,0.04022359848022461,1000,adapt,flocet,1
Flags,0.4166666567325592,0.48561739921569824,0.24723553657531738,1000,adapt,flocet,1
Glass,0.4716981053352356,0.19108796119689941,0.17786169052124023,1000,adapt,flocet,1
HabermanSurvival,0.5526315569877625,0.6568336486816406,0.12175703048706055,1000,adapt,flocet,1
HayesRoth,0.7857142686843872,0.21983051300048828,0.15227055549621582,1000,adapt,flocet,1
HeartCleveland,0.4736842215061188,0.3718376159667969,0.1184539794921875,1000,adapt,flocet,1
HeartHungarian,0.7945205569267273,0.26074910163879395,0.11391973495483398,1000,adapt,flocet,1
HeartSwitzerland,0.22580644488334656,0.29596900939941406,0.16533327102661133,1000,adapt,flocet,1
HeartVa,0.2800000011920929,0.26276731491088867,0.07848954200744629,1000,adapt,flocet,1
Hepatitis,0.7948718070983887,0.342848539352417,0.13950061798095703,1000,adapt,flocet,1
HillValley,0.4983498454093933,0.9163615703582764,1.388378381729126,1000,adapt,flocet,1
HorseColic,0.6764705777168274,0.8409903049468994,0.10799980163574219,1000,adapt,flocet,1
IlpdIndianLiver,0.7054794430732727,0.9945614337921143,0.24666285514831543,1000,adapt,flocet,1
ImageSegmentation,0.8199999928474426,0.5946722030639648,5.377137184143066,1000,adapt,flocet,1
Ionosphere,0.9090909361839294,0.6299633979797363,0.13698768615722656,1000,adapt,flocet,1
Iris,0.7027027010917664,0.25945162773132324,0.2004380226135254,1000,adapt,flocet,1
LedDisplay,0.6119999885559082,1.0609824657440186,0.6586706638336182,1000,adapt,flocet,1
Lenses,0.8333333134651184,0.039038658142089844,0.019863128662109375,1000,adapt,flocet,1
Letter,0.6995999813079834,20.836368322372437,14.481850385665894,1000,adapt,flocet,1
Libras,0.5,0.33340024948120117,0.36298465728759766,1000,adapt,flocet,1
LowResSpect,0.5413534045219421,0.5437359809875488,0.7152440547943115,1000,adapt,flocet,1
LungCancer,0.5,0.05123782157897949,0.0269622802734375,1000,adapt,flocet,1
Lymphography,0.8648648858070374,0.32454895973205566,0.20676851272583008,1000,adapt,flocet,1
Magic,0.746161937713623,22.16367506980896,10.119098424911499,1000,adapt,flocet,1
Mammographic,0.7291666865348816,1.267439842224121,0.49942898750305176,1000,adapt,flocet,1
Miniboone,0.3113851547241211,130.01016879081726,74.1023633480072,1000,adapt,flocet,1
MolecBiolPromoter,0.8846153616905212,0.20076918601989746,0.05547642707824707,1000,adapt,flocet,1
MolecBiolSplice,0.7503136992454529,3.317333459854126,2.0370655059814453,1000,adapt,flocet,1
Monks1,0.6944444179534912,0.2262279987335205,1.2946925163269043,1000,adapt,flocet,1
Monks2,0.9097222089767456,0.19926929473876953,0.6995277404785156,1000,adapt,flocet,1
Monks3,0.8981481194496155,0.2045900821685791,0.9359574317932129,1000,adapt,flocet,1
Mushroom,0.9960610270500183,8.706895112991333,4.3954596519470215,1000,adapt,flocet,1
Musk1,0.5882353186607361,0.7449240684509277,0.1859903335571289,1000,adapt,flocet,1
Musk2,0.9484536051750183,6.910414934158325,5.134289979934692,1000,adapt,flocet,1
Nursery,0.9256172776222229,15.564007759094238,9.22624921798706,1000,adapt,flocet,1
OocytesMerlucciusNucleus4d,0.6980392336845398,1.2983756065368652,0.3959386348724365,1000,adapt,flocet,1
OocytesMerlucciusStates2f,0.8470588326454163,1.6736793518066406,0.39592742919921875,1000,adapt,flocet,1
OocytesTrisopterusNucleus2f,0.6008771657943726,1.6451776027679443,0.355090856552124,1000,adapt,flocet,1
OocytesTrisopterusStates5b,0.859649121761322,0.7713484764099121,0.3550527095794678,1000,adapt,flocet,1
Optical,0.8981636166572571,6.3632354736328125,4.307947158813477,1000,adapt,flocet,1
Ozone,0.9621450901031494,2.858046054840088,1.490790843963623,1000,adapt,flocet,1
PageBlocks,0.9181286692619324,6.548083782196045,3.383467197418213,1000,adapt,flocet,1
Parkinsons,0.8979591727256775,0.23508715629577637,0.15944695472717285,1000,adapt,flocet,1
Pendigits,0.9385362863540649,11.36607813835144,8.590569734573364,1000,adapt,flocet,1
Pima,0.7083333134651184,0.828711748123169,0.2980997562408447,1000,adapt,flocet,1
PittsburgBridgesMaterial,0.5384615659713745,0.23978352546691895,0.10278868675231934,1000,adapt,flocet,1
PittsburgBridgesRelL,0.5769230723381042,0.1579582691192627,0.14086365699768066,1000,adapt,flocet,1
PittsburgBridgesSpan,0.739130437374115,0.14988112449645996,0.043846845626831055,1000,adapt,flocet,1
PittsburgBridgesTOrD,0.9200000166893005,0.18647336959838867,0.13515686988830566,1000,adapt,flocet,1
PittsburgBridgesType,0.5,0.12980365753173828,0.0962827205657959,1000,adapt,flocet,1
Planning,0.644444465637207,0.3926701545715332,0.20869088172912598,1000,adapt,flocet,1
PlantMargin,0.4650000035762787,2.3219664096832275,0.9511590003967285,1000,adapt,flocet,1
PlantShape,0.08250000327825546,2.2329843044281006,1.5202648639678955,1000,adapt,flocet,1
PlantTexture,0.4350000023841858,2.5035436153411865,1.6076545715332031,1000,adapt,flocet,1
PostOperative,0.5,0.19450020790100098,0.11973237991333008,1000,adapt,flocet,1
PrimaryTumor,0.3414634168148041,0.4342639446258545,0.17545413970947266,1000,adapt,flocet,1
Ringnorm,0.9032432436943054,8.471837282180786,5.097334384918213,1000,adapt,flocet,1
Seeds,0.8653846383094788,0.2351055145263672,0.08130741119384766,1000,adapt,flocet,1
Semeion,0.8517587780952454,2.0549581050872803,1.1093382835388184,1000,adapt,flocet,1
Soybean,0.7952127456665039,0.5828583240509033,0.8891499042510986,1000,adapt,flocet,1
Spambase,0.8669565320014954,5.138615369796753,3.0057449340820312,1000,adapt,flocet,1
Spect,0.6129032373428345,0.20061588287353516,0.5540432929992676,1000,adapt,flocet,1
Spectf,0.7860962748527527,0.23789048194885254,0.6732122898101807,1000,adapt,flocet,1
StatlogAustralianCredit,0.5058139562606812,1.0202510356903076,0.2807290554046631,1000,adapt,flocet,1
StatlogGermanCredit,0.6600000262260437,1.0318737030029297,0.49808311462402344,1000,adapt,flocet,1
StatlogHeart,0.8208954930305481,0.19394135475158691,0.10426878929138184,1000,adapt,flocet,1
StatlogImage,0.8076256513595581,2.348855495452881,1.1175060272216797,1000,adapt,flocet,1
StatlogLandsat,0.7875000238418579,5.883560657501221,5.418645620346069,1000,adapt,flocet,1
StatlogShuttle,0.8634482622146606,60.81242108345032,40.90823745727539,1000,adapt,flocet,1
StatlogVehicle,0.5971564054489136,0.9716379642486572,0.32824254035949707,1000,adapt,flocet,1
SteelPlates,0.6144329905509949,1.960768699645996,1.562239646911621,1000,adapt,flocet,1
SyntheticControl,0.8533333539962769,1.008962869644165,0.23308873176574707,1000,adapt,flocet,1
Teaching,0.4736842215061188,0.35796689987182617,0.20469880104064941,1000,adapt,flocet,1
Thyroid,0.6210618615150452,5.052133083343506,11.629053592681885,1000,adapt,flocet,1
TicTacToe,0.9497907757759094,0.8613495826721191,0.7383158206939697,1000,adapt,flocet,1
Titanic,0.7799999713897705,2.6728386878967285,1.0869176387786865,1000,adapt,flocet,1
Trains,1.0,0.018009424209594727,0.007965803146362305,1000,adapt,flocet,1
Twonorm,0.9605405330657959,7.037029981613159,3.816483974456787,1000,adapt,flocet,1
VertebralColumn2Clases,0.6883116960525513,0.5996003150939941,0.12173652648925781,1000,adapt,flocet,1
VertebralColumn3Clases,0.6883116960525513,0.2847900390625,0.11957359313964844,1000,adapt,flocet,1
WallFollowing,0.883431077003479,5.082903623580933,3.6923959255218506,1000,adapt,flocet,1
Waveform,0.7839999794960022,5.537156105041504,3.6727757453918457,1000,adapt,flocet,1
WaveformNoise,0.7799999713897705,4.731849670410156,3.069830894470215,1000,adapt,flocet,1
Wine,0.9090909361839294,0.3286926746368408,0.09854435920715332,1000,adapt,flocet,1
WineQualityRed,0.5099999904632568,1.394535779953003,0.8411943912506104,1000,adapt,flocet,1
WineQualityWhite,0.44281044602394104,6.231725215911865,3.725443124771118,1000,adapt,flocet,1
Yeast,0.4177897572517395,1.6754014492034912,1.261542797088623,1000,adapt,flocet,1
Zoo,0.8799999952316284,0.21502327919006348,0.13784527778625488,1000,adapt,flocet,1
Abalone,0.5316091775894165,4.65700626373291,2.1611809730529785,1000,online,flocet,1
AcuteInflammation,1.0,0.23537445068359375,0.14055633544921875,1000,online,flocet,1
AcuteNephritis,1.0,0.2237834930419922,0.050431251525878906,1000,online,flocet,1
Adult,0.8006879091262817,51.13046860694885,38.07345747947693,1000,online,flocet,1
Annealing,0.9300000071525574,1.1143436431884766,0.27692508697509766,1000,online,flocet,1
Arrhythmia,0.20353981852531433,0.4371027946472168,0.17646503448486328,1000,online,flocet,1
AudiologyStd,0.3199999928474426,0.3421053886413574,0.08562135696411133,1000,online,flocet,1
BalanceScale,0.8782051205635071,0.5063636302947998,0.4483458995819092,1000,online,flocet,1
Balloons,1.0,0.0220944881439209,0.007642507553100586,1000,online,flocet,1
Bank,0.8548672795295715,5.653121471405029,3.124640464782715,1000,online,flocet,1
Blood,0.7379679083824158,1.236553430557251,0.7349364757537842,1000,online,flocet,1
BreastCancer,0.6197183132171631,0.3377716541290283,0.38492631912231445,1000,online,flocet,1
BreastCancerWisc,0.9657142758369446,0.7204201221466064,0.6324992179870605,1000,online,flocet,1
BreastCancerWiscDiag,0.9577465057373047,0.45241475105285645,0.300140380859375,1000,online,flocet,1
BreastCancerWiscProg,0.7142857313156128,0.2818121910095215,0.07696843147277832,1000,online,flocet,1
BreastTissue,0.7307692170143127,0.26499342918395996,0.1408555507659912,1000,online,flocet,1
Car,0.8912037014961243,2.0342116355895996,1.2437174320220947,1000,online,flocet,1
Cardiotocography10Clases,0.7137476205825806,3.1966018676757812,1.7045516967773438,1000,online,flocet,1
Cardiotocography3Clases,0.8644067645072937,2.4534783363342285,1.0077149868011475,1000,online,flocet,1
ChessKrvk,0.3990590274333954,42.982311964035034,20.972814083099365,1000,online,flocet,1
ChessKrvkp,0.8911138772964478,3.6912968158721924,1.9261252880096436,1000,online,flocet,1
CongressionalVoting,0.6330274939537048,0.7504870891571045,0.16937041282653809,1000,online,flocet,1
ConnBenchSonarMinesRocks,0.692307710647583,0.4549252986907959,0.27902793884277344,1000,online,flocet,1
ConnBenchVowelDeterding,0.6536796689033508,1.2358498573303223,1.0649664402008057,1000,online,flocet,1
Connect4,0.7851263880729675,101.50840902328491,46.37690353393555,1000,online,flocet,1
Contrac,0.41847825050354004,2.1287178993225098,0.6981475353240967,1000,online,flocet,1
CreditApproval,0.8255813717842102,0.6804306507110596,0.26883983612060547,1000,online,flocet,1
CylinderBands,0.7109375,0.5876679420471191,0.6829979419708252,1000,online,flocet,1
Dermatology,0.9120879173278809,0.7941439151763916,0.21289348602294922,1000,online,flocet,1
Echocardiogram,0.8181818127632141,0.28449106216430664,0.17786192893981934,1000,online,flocet,1
Ecoli,0.8571428656578064,0.5062389373779297,0.13041305541992188,1000,online,flocet,1
EnergyY1,0.9166666865348816,1.5640089511871338,0.5320923328399658,1000,online,flocet,1
EnergyY2,0.84375,0.9598968029022217,0.7971932888031006,1000,online,flocet,1
Fertility,0.8799999952316284,0.21818232536315918,0.1354999542236328,1000,online,flocet,1
Flags,0.5416666865348816,0.4754016399383545,0.07622885704040527,1000,online,flocet,1
Glass,0.3396226465702057,0.5819370746612549,0.2831122875213623,1000,online,flocet,1
HabermanSurvival,0.7105262875556946,0.5511951446533203,0.40739870071411133,1000,online,flocet,1
HayesRoth,0.6785714030265808,0.2002568244934082,0.1502985954284668,1000,online,flocet,1
HeartCleveland,0.5,0.6713907718658447,0.23788189888000488,1000,online,flocet,1
HeartHungarian,0.5890411138534546,0.690640926361084,0.11681509017944336,1000,online,flocet,1
HeartSwitzerland,0.25806450843811035,0.3599543571472168,0.16706418991088867,1000,online,flocet,1
HeartVa,0.25999999046325684,0.21772360801696777,0.12865591049194336,1000,online,flocet,1
Hepatitis,0.8717948794364929,0.25912022590637207,0.2112748622894287,1000,online,flocet,1
HillValley,0.5165016651153564,0.900606632232666,2.1538608074188232,1000,online,flocet,1
HorseColic,0.6911764740943909,0.5066840648651123,0.10544252395629883,1000,online,flocet,1
IlpdIndianLiver,0.698630154132843,0.8916950225830078,0.6526081562042236,1000,online,flocet,1
ImageSegmentation,0.7561904788017273,0.2818434238433838,5.947175979614258,1000,online,flocet,1
Ionosphere,0.8522727489471436,0.832305908203125,0.14906764030456543,1000,online,flocet,1
Iris,0.9729729890823364,0.17937684059143066,0.20096325874328613,1000,online,flocet,1
LedDisplay,0.6919999718666077,1.647789716720581,0.4331049919128418,1000,online,flocet,1
Lenses,0.8333333134651184,0.0491940975189209,0.03373599052429199,1000,online,flocet,1
Letter,0.7522000074386597,23.113460779190063,14.252146005630493,1000,online,flocet,1
Libras,0.5777778029441833,0.7224361896514893,0.14072680473327637,1000,online,flocet,1
LowResSpect,0.8872180581092834,0.7102603912353516,0.26628637313842773,1000,online,flocet,1
LungCancer,0.375,0.09522485733032227,0.04453635215759277,1000,online,flocet,1
Lymphography,0.8648648858070374,0.3441786766052246,0.19921183586120605,1000,online,flocet,1
Magic,0.7228180766105652,21.578600645065308,15.398642778396606,1000,online,flocet,1
Mammographic,0.7083333134651184,1.8214006423950195,0.512141227722168,1000,online,flocet,1
Miniboone,0.774049699306488,161.7367913722992,87.7231502532959,1000,online,flocet,1
MolecBiolPromoter,0.8461538553237915,0.09267234802246094,0.04123973846435547,1000,online,flocet,1
MolecBiolSplice,0.7340025305747986,3.4962921142578125,2.525305986404419,1000,online,flocet,1
Monks1,0.6643518805503845,0.38672447204589844,1.0286362171173096,1000,online,flocet,1
Monks2,0.9444444179534912,0.35833740234375,0.9895009994506836,1000,online,flocet,1
Monks3,0.8078703880310059,0.36812520027160645,1.5043690204620361,1000,online,flocet,1
Mushroom,0.9980305433273315,9.842660903930664,7.251415491104126,1000,online,flocet,1
Musk1,0.5798319578170776,0.9487740993499756,0.5661826133728027,1000,online,flocet,1
Musk2,0.9490600228309631,9.918245077133179,4.952461242675781,1000,online,flocet,1
Nursery,0.9120370149612427,18.123918771743774,9.705694675445557,1000,online,flocet,1
OocytesMerlucciusNucleus4d,0.7098039388656616,1.3150157928466797,1.235325813293457,1000,online,flocet,1
OocytesMerlucciusStates2f,0.8745098114013672,1.199953556060791,0.8195862770080566,1000,online,flocet,1
OocytesTrisopterusNucleus2f,0.7017543911933899,1.644653081893921,0.6474664211273193,1000,online,flocet,1
OocytesTrisopterusStates5b,0.8421052694320679,1.238875389099121,0.35245275497436523,1000,online,flocet,1
Optical,0.902615487575531,6.158208131790161,4.072182655334473,1000,online,flocet,1
Ozone,0.9432176947593689,3.1774401664733887,2.139814853668213,1000,online,flocet,1
PageBlocks,0.9013158082962036,6.844470024108887,4.103223562240601,1000,online,flocet,1
Parkinsons,0.8571428656578064,0.3875284194946289,0.07843565940856934,1000,online,flocet,1
Pendigits,0.9336763620376587,11.94817328453064,10.042441606521606,1000,online,flocet,1
Pima,0.6979166865348816,0.93863844871521,0.29759740829467773,1000,online,flocet,1
PittsburgBridgesMaterial,0.8846153616905212,0.23122882843017578,0.08606791496276855,1000,online,flocet,1
PittsburgBridgesRelL,0.692307710647583,0.2151792049407959,0.043340206146240234,1000,online,flocet,1
PittsburgBridgesSpan,0.5652173757553101,0.19091105461120605,0.12595105171203613,1000,online,flocet,1
PittsburgBridgesTOrD,0.8799999952316284,0.22973012924194336,0.11687302589416504,1000,online,flocet,1
PittsburgBridgesType,0.5384615659713745,0.23888325691223145,0.04491400718688965,1000,online,flocet,1
Planning,0.5555555820465088,0.3923156261444092,0.24309039115905762,1000,online,flocet,1
PlantMargin,0.5350000262260437,2.908001184463501,1.0683062076568604,1000,online,flocet,1
PlantShape,0.26499998569488525,2.3194172382354736,1.0622501373291016,1000,online,flocet,1
PlantTexture,0.5149999856948853,2.810087203979492,1.1536250114440918,1000,online,flocet,1
PostOperative,0.4545454680919647,0.2122182846069336,0.11890840530395508,1000,online,flocet,1
PrimaryTumor,0.26829269528388977,0.6114733219146729,0.13371753692626953,1000,online,flocet,1
Ringnorm,0.9162161946296692,9.666308879852295,5.312674045562744,1000,online,flocet,1
Seeds,0.8653846383094788,0.44415831565856934,0.13542485237121582,1000,online,flocet,1
Semeion,0.8668341636657715,2.696195125579834,1.2669684886932373,1000,online,flocet,1
Soybean,0.8484042286872864,0.8406085968017578,0.897388219833374,1000,online,flocet,1
Spambase,0.8782608509063721,6.9704859256744385,3.458930730819702,1000,online,flocet,1
Spect,0.5913978219032288,0.22433757781982422,0.476360559463501,1000,online,flocet,1
Spectf,0.5080214142799377,0.2720966339111328,0.6038849353790283,1000,online,flocet,1
StatlogAustralianCredit,0.6337209343910217,1.1100976467132568,0.37128305435180664,1000,online,flocet,1
StatlogGermanCredit,0.6880000233650208,1.4428198337554932,1.0078701972961426,1000,online,flocet,1
StatlogHeart,0.8805969953536987,0.547025203704834,0.10703921318054199,1000,online,flocet,1
StatlogImage,0.909878671169281,2.455388069152832,1.858494758605957,1000,online,flocet,1
StatlogLandsat,0.847000002861023,7.3132524490356445,5.762391805648804,1000,online,flocet,1
StatlogShuttle,0.1398620754480362,66.5299563407898,39.23060083389282,1000,online,flocet,1
StatlogVehicle,0.5639810562133789,1.2356817722320557,0.6748843193054199,1000,online,flocet,1
SteelPlates,0.6000000238418579,2.176598072052002,1.5452873706817627,1000,online,flocet,1
SyntheticControl,0.9066666960716248,0.8951728343963623,0.23377156257629395,1000,online,flocet,1
Teaching,0.3684210479259491,0.380126953125,0.1683201789855957,1000,online,flocet,1
Thyroid,0.868144690990448,4.916673421859741,9.723427772521973,1000,online,flocet,1
TicTacToe,0.9414225816726685,0.8503198623657227,0.722567081451416,1000,online,flocet,1
Titanic,0.6345454454421997,3.163308620452881,1.8416814804077148,1000,online,flocet,1
Trains,0.5,0.01993584632873535,0.007867574691772461,1000,online,flocet,1
Twonorm,0.9643242955207825,9.822043180465698,5.159344673156738,1000,online,flocet,1
VertebralColumn2Clases,0.7662337422370911,0.5702149868011475,0.2945420742034912,1000,online,flocet,1
VertebralColumn3Clases,0.5194805264472961,0.5313711166381836,0.40986108779907227,1000,online,flocet,1
WallFollowing,0.9017595052719116,7.074365139007568,3.6252214908599854,1000,online,flocet,1
Waveform,0.8047999739646912,5.332606315612793,3.1268959045410156,1000,online,flocet,1
WaveformNoise,0.8119999766349792,5.724663257598877,3.1890852451324463,1000,online,flocet,1
Wine,0.9772727489471436,0.42000722885131836,0.1897742748260498,1000,online,flocet,1
WineQualityRed,0.5149999856948853,2.2246005535125732,1.5741147994995117,1000,online,flocet,1
WineQualityWhite,0.45261436700820923,6.413461446762085,3.697580337524414,1000,online,flocet,1
Yeast,0.49056604504585266,2.1287026405334473,0.996002197265625,1000,online,flocet,1
Zoo,0.9200000166893005,0.18433713912963867,0.13530349731445312,1000,online,flocet,1
Abalone,0.5842911601066589,6.323742628097534,4.053648948669434,1000,adjust,flocet,1
AcuteInflammation,1.0,0.10879397392272949,0.04728817939758301,1000,adjust,flocet,1
AcuteNephritis,1.0,0.2844367027282715,0.16199517250061035,1000,adjust,flocet,1
Adult,0.798906683921814,57.70406770706177,41.58060359954834,1000,adjust,flocet,1
Annealing,0.47999998927116394,1.8189058303833008,0.15906596183776855,1000,adjust,flocet,1
Arrhythmia,0.2654867172241211,1.0227878093719482,0.6072440147399902,1000,adjust,flocet,1
AudiologyStd,0.6399999856948853,0.3173792362213135,0.13610076904296875,1000,adjust,flocet,1
BalanceScale,0.9166666865348816,0.7275140285491943,0.24313068389892578,1000,adjust,flocet,1
Balloons,1.0,0.03149843215942383,0.02085566520690918,1000,adjust,flocet,1
Bank,0.8672566413879395,6.519046783447266,3.112295627593994,1000,adjust,flocet,1
Blood,0.7379679083824158,1.1782572269439697,0.6619172096252441,1000,adjust,flocet,1
BreastCancer,0.5352112650871277,0.7325160503387451,0.2604944705963135,1000,adjust,flocet,1
BreastCancerWisc,0.9714285731315613,1.002065658569336,0.271653413772583,1000,adjust,flocet,1
BreastCancerWiscDiag,0.9718309640884399,1.133603811264038,0.3966083526611328,1000,adjust,flocet,1
BreastCancerWiscProg,0.7346938848495483,0.27653932571411133,0.26568031311035156,1000,adjust,flocet,1
BreastTissue,0.6538461446762085,0.2942039966583252,0.14084219932556152,1000,adjust,flocet,1
Car,0.8796296119689941,2.3248021602630615,1.182546615600586,1000,adjust,flocet,1
Cardiotocography10Clases,0.7193973660469055,2.929978609085083,1.7746264934539795,1000,adjust,flocet,1
Cardiotocography3Clases,0.8907721042633057,3.340750217437744,1.6244935989379883,1000,adjust,flocet,1
ChessKrvk,0.41132020950317383,56.85596251487732,22.403179168701172,1000,adjust,flocet,1
ChessKrvkp,0.9236545562744141,4.4911370277404785,2.0362446308135986,1000,adjust,flocet,1
CongressionalVoting,0.5229358077049255,0.967515230178833,0.41613054275512695,1000,adjust,flocet,1
ConnBenchSonarMinesRocks,0.692307710647583,0.47014594078063965,0.08229494094848633,1000,adjust,flocet,1
ConnBenchVowelDeterding,0.7878788113594055,1.6061997413635254,1.1919269561767578,1000,adjust,flocet,1
Connect4,0.7550476789474487,102.51730680465698,44.75256633758545,1000,adjust,flocet,1
Contrac,0.5054348111152649,1.8783371448516846,1.0169041156768799,1000,adjust,flocet,1
CreditApproval,0.854651153087616,0.9926419258117676,0.625830888748169,1000,adjust,flocet,1
CylinderBands,0.671875,1.1030845642089844,0.19876670837402344,1000,adjust,flocet,1
Dermatology,0.9670329689979553,0.5319154262542725,0.1415081024169922,1000,adjust,flocet,1
Echocardiogram,0.8484848737716675,0.33315420150756836,0.17777442932128906,1000,adjust,flocet,1
Ecoli,0.8571428656578064,0.5792133808135986,0.13090872764587402,1000,adjust,flocet,1
EnergyY1,0.859375,1.1259701251983643,0.719916820526123,1000,adjust,flocet,1
EnergyY2,0.8645833134651184,1.1860566139221191,0.5248677730560303,1000,adjust,flocet,1
Fertility,0.800000011920929,0.16242694854736328,0.04011225700378418,1000,adjust,flocet,1
Flags,0.5416666865348816,0.5487468242645264,0.2574949264526367,1000,adjust,flocet,1
Glass,0.22641509771347046,0.2307133674621582,0.08271312713623047,1000,adjust,flocet,1
HabermanSurvival,0.6710526347160339,0.7652277946472168,0.12029814720153809,1000,adjust,flocet,1
HayesRoth,0.7142857313156128,0.4850132465362549,0.15076899528503418,1000,adjust,flocet,1
HeartCleveland,0.5526315569877625,0.37290430068969727,0.11788153648376465,1000,adjust,flocet,1
HeartHungarian,0.7945205569267273,0.7006874084472656,0.1150350570678711,1000,adjust,flocet,1
HeartSwitzerland,0.4193548262119293,0.366194486618042,0.16725587844848633,1000,adjust,flocet,1
HeartVa,0.3199999928474426,0.3724231719970703,0.07870817184448242,1000,adjust,flocet,1
Hepatitis,0.8205128312110901,0.40443968772888184,0.20876646041870117,1000,adjust,flocet,1
HillValley,0.5247524976730347,1.2394351959228516,1.7292287349700928,1000,adjust,flocet,1
HorseColic,0.6911764740943909,0.37607812881469727,0.10670971870422363,1000,adjust,flocet,1
IlpdIndianLiver,0.6575342416763306,0.9077520370483398,0.5818147659301758,1000,adjust,flocet,1
ImageSegmentation,0.7904762029647827,0.2844071388244629,5.830880880355835,1000,adjust,flocet,1
Ionosphere,0.8181818127632141,0.9142732620239258,0.16205835342407227,1000,adjust,flocet,1
Iris,0.9729729890823364,0.3706083297729492,0.19937586784362793,1000,adjust,flocet,1
LedDisplay,0.7599999904632568,1.2230191230773926,0.3883800506591797,1000,adjust,flocet,1
Lenses,0.8333333134651184,0.07844877243041992,0.03383231163024902,1000,adjust,flocet,1
Letter,0.7350000143051147,29.089247465133667,14.582561731338501,1000,adjust,flocet,1
Libras,0.6222222447395325,0.6644303798675537,0.32566142082214355,1000,adjust,flocet,1
LowResSpect,0.7443609237670898,0.7419009208679199,0.5172574520111084,1000,adjust,flocet,1
LungCancer,0.5,0.08137083053588867,0.04460883140563965,1000,adjust,flocet,1
Lymphography,0.8918918967247009,0.16553354263305664,0.058379411697387695,1000,adjust,flocet,1
Magic,0.7718191146850586,25.84824800491333,12.337800979614258,1000,adjust,flocet,1
Mammographic,0.7916666865348816,1.508833408355713,0.4848752021789551,1000,adjust,flocet,1
Miniboone,0.28444457054138184,189.97925782203674,96.72621726989746,1000,adjust,flocet,1
MolecBiolPromoter,0.807692289352417,0.17013955116271973,0.12226986885070801,1000,adjust,flocet,1
MolecBiolSplice,0.7352572083473206,4.394125938415527,2.6414246559143066,1000,adjust,flocet,1
Monks1,0.6759259104728699,0.43984317779541016,1.1700925827026367,1000,adjust,flocet,1
Monks2,0.9652777910232544,0.2436375617980957,1.0627615451812744,1000,adjust,flocet,1
Monks3,0.9305555820465088,0.42302370071411133,1.85182523727417,1000,adjust,flocet,1
Mushroom,0.9980305433273315,10.607409715652466,6.840553522109985,1000,adjust,flocet,1
Musk1,0.680672287940979,0.7674562931060791,0.41841983795166016,1000,adjust,flocet,1
Musk2,0.9478471875190735,10.376153945922852,5.678986310958862,1000,adjust,flocet,1
Nursery,0.915123462677002,17.107985019683838,8.836349964141846,1000,adjust,flocet,1
OocytesMerlucciusNucleus4d,0.615686297416687,1.638610601425171,0.7017364501953125,1000,adjust,flocet,1
OocytesMerlucciusStates2f,0.8666666746139526,1.1606292724609375,0.6303479671478271,1000,adjust,flocet,1
OocytesTrisopterusNucleus2f,0.6754385828971863,1.1373131275177002,0.5154497623443604,1000,adjust,flocet,1
OocytesTrisopterusStates5b,0.7894737124443054,1.1169135570526123,0.8047940731048584,1000,adjust,flocet,1
Optical,0.9371173977851868,8.270720958709717,5.510519027709961,1000,adjust,flocet,1
Ozone,0.9716088175773621,3.0999839305877686,1.840888500213623,1000,adjust,flocet,1
PageBlocks,0.9115496873855591,8.138603925704956,4.096519708633423,1000,adjust,flocet,1
Parkinsons,0.8163265585899353,0.4759352207183838,0.23978209495544434,1000,adjust,flocet,1
Pendigits,0.9545454382896423,13.184796571731567,9.144044399261475,1000,adjust,flocet,1
Pima,0.7135416865348816,1.0606403350830078,0.5490307807922363,1000,adjust,flocet,1
PittsburgBridgesMaterial,0.8461538553237915,0.09172964096069336,0.1367781162261963,1000,adjust,flocet,1
PittsburgBridgesRelL,0.5769230723381042,0.12158584594726562,0.1354234218597412,1000,adjust,flocet,1
PittsburgBridgesSpan,0.739130437374115,0.23938727378845215,0.03920745849609375,1000,adjust,flocet,1
PittsburgBridgesTOrD,0.9200000166893005,0.22988057136535645,0.042760372161865234,1000,adjust,flocet,1
PittsburgBridgesType,0.42307692766189575,0.31731534004211426,0.1408851146697998,1000,adjust,flocet,1
Planning,0.6666666865348816,0.4759056568145752,0.07246875762939453,1000,adjust,flocet,1
PlantMargin,0.5724999904632568,2.939462184906006,1.0782318115234375,1000,adjust,flocet,1
PlantShape,0.2849999964237213,2.8161115646362305,0.9982936382293701,1000,adjust,flocet,1
PlantTexture,0.5724999904632568,2.936502456665039,1.3572189807891846,1000,adjust,flocet,1
PostOperative,0.5,0.22945713996887207,0.09895682334899902,1000,adjust,flocet,1
PrimaryTumor,0.37804877758026123,0.43289804458618164,0.12815380096435547,1000,adjust,flocet,1
Ringnorm,0.9172973036766052,10.67803168296814,5.673705816268921,1000,adjust,flocet,1
Seeds,0.942307710647583,0.30317044258117676,0.12381649017333984,1000,adjust,flocet,1
Semeion,0.8542713522911072,2.495084762573242,1.1075830459594727,1000,adjust,flocet,1
Soybean,0.8164893388748169,0.4847590923309326,0.640669584274292,1000,adjust,flocet,1
Spambase,0.8173912763595581,6.625658273696899,2.7216343879699707,1000,adjust,flocet,1
Spect,0.6505376100540161,0.20309138298034668,0.29259371757507324,1000,adjust,flocet,1
Spectf,0.903743326663971,0.31624817848205566,0.5442423820495605,1000,adjust,flocet,1
StatlogAustralianCredit,0.6220930218696594,1.1146824359893799,0.7116596698760986,1000,adjust,flocet,1
StatlogGermanCredit,0.7440000176429749,2.0266735553741455,0.46191859245300293,1000,adjust,flocet,1
StatlogHeart,0.8059701323509216,0.43126368522644043,0.10493779182434082,1000,adjust,flocet,1
StatlogImage,0.9150779843330383,3.3631362915039062,1.5101072788238525,1000,adjust,flocet,1
StatlogLandsat,0.8040000200271606,8.464844703674316,5.9540088176727295,1000,adjust,flocet,1
StatlogShuttle,0.862551748752594,75.86664271354675,40.588160276412964,1000,adjust,flocet,1
StatlogVehicle,0.6066350936889648,1.5540721416473389,0.4440336227416992,1000,adjust,flocet,1
SteelPlates,0.6721649765968323,2.791745185852051,1.142850637435913,1000,adjust,flocet,1
SyntheticControl,0.95333331823349,0.9741151332855225,0.5333957672119141,1000,adjust,flocet,1
Teaching,0.5789473652839661,0.26737475395202637,0.06046032905578613,1000,adjust,flocet,1
Thyroid,0.8086347579956055,7.066331386566162,9.960505962371826,1000,adjust,flocet,1
TicTacToe,0.9121338725090027,1.5675885677337646,0.8534510135650635,1000,adjust,flocet,1
Titanic,0.7818182110786438,2.379889488220215,2.034193992614746,1000,adjust,flocet,1
Trains,1.0,0.022713661193847656,0.007454395294189453,1000,adjust,flocet,1
Twonorm,0.9664865136146545,9.588517665863037,4.909383296966553,1000,adjust,flocet,1
VertebralColumn2Clases,0.7402597665786743,0.3780221939086914,0.12128758430480957,1000,adjust,flocet,1
VertebralColumn3Clases,0.5584415793418884,0.7512764930725098,0.1209249496459961,1000,adjust,flocet,1
WallFollowing,0.8731671571731567,8.803718090057373,4.0105602741241455,1000,adjust,flocet,1
Waveform,0.8240000009536743,9.065428495407104,4.201345920562744,1000,adjust,flocet,1
WaveformNoise,0.8040000200271606,9.75165605545044,5.564051628112793,1000,adjust,flocet,1
Wine,1.0,0.33458614349365234,0.23623132705688477,1000,adjust,flocet,1
WineQualityRed,0.5024999976158142,4.091033458709717,1.5898866653442383,1000,adjust,flocet,1
WineQualityWhite,0.4387255012989044,11.305338621139526,4.413290739059448,1000,adjust,flocet,1
Yeast,0.4959568679332733,3.1337223052978516,1.2536556720733643,1000,adjust,flocet,1
Zoo,0.8799999952316284,0.24539494514465332,0.13560128211975098,1000,adjust,flocet,1
Abalone,0.5210728049278259,6.920546054840088,3.0980563163757324,500,adapt,flocet,1
AcuteInflammation,1.0,0.16793346405029297,0.11800789833068848,500,adapt,flocet,1
AcuteNephritis,1.0,0.24932384490966797,0.16138982772827148,500,adapt,flocet,1
Adult,0.8261777758598328,63.40985679626465,48.87597846984863,500,adapt,flocet,1
Annealing,0.6299999952316284,2.0224201679229736,0.5034959316253662,500,adapt,flocet,1
Arrhythmia,0.6106194853782654,0.5158183574676514,0.48549413681030273,500,adapt,flocet,1
AudiologyStd,0.0,0.3525981903076172,0.039693355560302734,500,adapt,flocet,1
BalanceScale,0.9102563858032227,1.0097095966339111,0.5163145065307617,500,adapt,flocet,1
Balloons,0.75,0.025900602340698242,0.013059139251708984,500,adapt,flocet,1
Bank,0.8858407139778137,5.187698125839233,3.3116707801818848,500,adapt,flocet,1
Blood,0.45989304780960083,0.97601318359375,0.8187923431396484,500,adapt,flocet,1
BreastCancer,0.7183098793029785,0.6038682460784912,0.3064882755279541,500,adapt,flocet,1
BreastCancerWisc,0.977142870426178,0.9775724411010742,0.27792954444885254,500,adapt,flocet,1
BreastCancerWiscDiag,0.9647887349128723,0.6772904396057129,0.22181320190429688,500,adapt,flocet,1
BreastCancerWiscProg,0.5306122303009033,0.44216346740722656,0.26293039321899414,500,adapt,flocet,1
BreastTissue,0.5,0.16373991966247559,0.14055562019348145,500,adapt,flocet,1
Car,0.8773148059844971,2.866077184677124,1.3201813697814941,500,adapt,flocet,1
Cardiotocography10Clases,0.6384180784225464,2.630727767944336,1.8512887954711914,500,adapt,flocet,1
Cardiotocography3Clases,0.8549906015396118,3.9188039302825928,1.4570353031158447,500,adapt,flocet,1
ChessKrvk,0.38964927196502686,43.9518346786499,23.55670475959778,500,adapt,flocet,1
ChessKrvkp,0.8836045265197754,3.904477596282959,2.7959394454956055,500,adapt,flocet,1
CongressionalVoting,0.5229358077049255,0.7240862846374512,0.48322129249572754,500,adapt,flocet,1
ConnBenchSonarMinesRocks,0.7307692170143127,0.4634997844696045,0.2790389060974121,500,adapt,flocet,1
ConnBenchVowelDeterding,0.6298701167106628,1.2401940822601318,1.7507102489471436,500,adapt,flocet,1
Connect4,0.7816922068595886,95.33929324150085,60.307480335235596,500,adapt,flocet,1
Contrac,0.42934781312942505,2.2964861392974854,1.136272668838501,500,adapt,flocet,1
CreditApproval,0.819767415523529,1.0312466621398926,0.7876648902893066,500,adapt,flocet,1
CylinderBands,0.59375,0.9583196640014648,0.20038938522338867,500,adapt,flocet,1
Dermatology,0.8351648449897766,0.7727982997894287,0.143082857131958,500,adapt,flocet,1
Echocardiogram,0.7878788113594055,0.28390049934387207,0.17791032791137695,500,adapt,flocet,1
Ecoli,0.8690476417541504,0.282123327255249,0.2859656810760498,500,adapt,flocet,1
EnergyY1,0.9010416865348816,1.0804641246795654,0.8778440952301025,500,adapt,flocet,1
EnergyY2,0.8541666865348816,1.0874359607696533,0.7746255397796631,500,adapt,flocet,1
Fertility,0.9200000166893005,0.20862531661987305,0.13506221771240234,500,adapt,flocet,1
Flags,0.5833333134651184,0.44240522384643555,0.11466670036315918,500,adapt,flocet,1
Glass,0.4716981053352356,0.5076117515563965,0.28501367568969727,500,adapt,flocet,1
HabermanSurvival,0.4868420958518982,0.2844963073730469,0.1897425651550293,500,adapt,flocet,1
HayesRoth,0.5714285969734192,0.36348986625671387,0.15137529373168945,500,adapt,flocet,1
HeartCleveland,0.4868420958518982,0.6665899753570557,0.24432826042175293,500,adapt,flocet,1
HeartHungarian,0.698630154132843,0.5797076225280762,0.39092421531677246,500,adapt,flocet,1
HeartSwitzerland,0.4516128897666931,0.21559548377990723,0.05076193809509277,500,adapt,flocet,1
HeartVa,0.3199999928474426,0.4594719409942627,0.193312406539917,500,adapt,flocet,1
Hepatitis,0.7948718070983887,0.29904961585998535,0.2102799415588379,500,adapt,flocet,1
HillValley,0.5016501545906067,1.3677754402160645,2.024390697479248,500,adapt,flocet,1
HorseColic,0.7647058963775635,0.6330654621124268,0.36463189125061035,500,adapt,flocet,1
IlpdIndianLiver,0.6575342416763306,1.03761625289917,0.2263500690460205,500,adapt,flocet,1
ImageSegmentation,0.739047646522522,0.6388990879058838,7.03377628326416,500,adapt,flocet,1
Ionosphere,0.9204545617103577,0.4128267765045166,0.26574254035949707,500,adapt,flocet,1
Iris,0.9729729890823364,0.3299117088317871,0.19908809661865234,500,adapt,flocet,1
LedDisplay,0.5559999942779541,1.83204984664917,1.043541669845581,500,adapt,flocet,1
Lenses,0.8333333134651184,0.04414248466491699,0.03394126892089844,500,adapt,flocet,1
Letter,0.6926000118255615,29.04222011566162,15.930518388748169,500,adapt,flocet,1
Libras,0.5111111402511597,0.8409013748168945,0.43719482421875,500,adapt,flocet,1
LowResSpect,0.6691729426383972,0.5396041870117188,0.27451658248901367,500,adapt,flocet,1
LungCancer,0.25,0.059103965759277344,0.044301509857177734,500,adapt,flocet,1
Lymphography,0.7837837934494019,0.3307991027832031,0.1965634822845459,500,adapt,flocet,1
Magic,0.8090431094169617,26.279970169067383,12.623763799667358,500,adapt,flocet,1
Mammographic,0.7124999761581421,2.052659511566162,0.37253284454345703,500,adapt,flocet,1
Miniboone,0.2830298840999603,155.82277846336365,84.50593972206116,500,adapt,flocet,1
MolecBiolPromoter,0.8461538553237915,0.18850469589233398,0.1404862403869629,500,adapt,flocet,1
MolecBiolSplice,0.6587201952934265,3.3753533363342285,2.020189046859741,500,adapt,flocet,1
Monks1,0.6620370149612427,0.3352212905883789,1.7743191719055176,500,adapt,flocet,1
Monks2,0.8842592835426331,0.4039778709411621,1.2914538383483887,500,adapt,flocet,1
Monks3,0.8495370149612427,0.26852965354919434,1.8696951866149902,500,adapt,flocet,1
Mushroom,0.9955686926841736,7.673351526260376,3.633296251296997,500,adapt,flocet,1
Musk1,0.605042040348053,0.4072389602661133,0.18556761741638184,500,adapt,flocet,1
Musk2,0.8768950700759888,7.304410457611084,2.895559072494507,500,adapt,flocet,1
Nursery,0.9141975045204163,10.134163618087769,5.684296369552612,500,adapt,flocet,1
OocytesMerlucciusNucleus4d,0.6117647290229797,1.3557119369506836,0.3968524932861328,500,adapt,flocet,1
OocytesMerlucciusStates2f,0.7960784435272217,0.7755370140075684,0.4763491153717041,500,adapt,flocet,1
OocytesTrisopterusNucleus2f,0.6754385828971863,1.951899766921997,0.3537311553955078,500,adapt,flocet,1
OocytesTrisopterusStates5b,0.8464912176132202,1.6980185508728027,0.3546009063720703,500,adapt,flocet,1
Optical,0.8686699867248535,4.724330902099609,3.753549337387085,500,adapt,flocet,1
Ozone,0.9731861352920532,2.5340511798858643,1.230466365814209,500,adapt,flocet,1
PageBlocks,0.9247075915336609,4.6953959465026855,2.6429388523101807,500,adapt,flocet,1
Parkinsons,0.7755101919174194,0.42476487159729004,0.2638816833496094,500,adapt,flocet,1
Pendigits,0.9362492561340332,8.557151079177856,9.699162244796753,500,adapt,flocet,1
Pima,0.703125,1.6603219509124756,0.8663442134857178,500,adapt,flocet,1
PittsburgBridgesMaterial,0.8846153616905212,0.13431525230407715,0.04193997383117676,500,adapt,flocet,1
PittsburgBridgesRelL,0.6153846383094788,0.13584041595458984,0.04137897491455078,500,adapt,flocet,1
PittsburgBridgesSpan,0.6086956262588501,0.2038440704345703,0.12476706504821777,500,adapt,flocet,1
PittsburgBridgesTOrD,0.8799999952316284,0.21350312232971191,0.13532137870788574,500,adapt,flocet,1
PittsburgBridgesType,0.6538461446762085,0.11647725105285645,0.04190993309020996,500,adapt,flocet,1
Planning,0.6666666865348816,0.421647310256958,0.241868257522583,500,adapt,flocet,1
PlantMargin,0.3125,3.1471164226531982,1.633333683013916,500,adapt,flocet,1
PlantShape,0.11500000208616257,2.1118857860565186,1.2190322875976562,500,adapt,flocet,1
PlantTexture,0.38499999046325684,2.0361101627349854,1.0425679683685303,500,adapt,flocet,1
PostOperative,0.4545454680919647,0.17615365982055664,0.1193091869354248,500,adapt,flocet,1
PrimaryTumor,0.2804878056049347,0.5761942863464355,0.2597784996032715,500,adapt,flocet,1
Ringnorm,0.9491891860961914,9.78539252281189,4.5552167892456055,500,adapt,flocet,1
Seeds,0.8846153616905212,0.2516195774078369,0.08172059059143066,500,adapt,flocet,1
Semeion,0.8090452551841736,1.976675271987915,0.7839357852935791,500,adapt,flocet,1
Soybean,0.8085106611251831,0.9074757099151611,0.586057186126709,500,adapt,flocet,1
Spambase,0.8643478155136108,4.6258015632629395,4.946222543716431,500,adapt,flocet,1
Spect,0.6451612710952759,0.21970868110656738,0.9768211841583252,500,adapt,flocet,1
Spectf,0.2085561454296112,0.22116589546203613,0.29489779472351074,500,adapt,flocet,1
StatlogAustralianCredit,0.6279069781303406,1.352921962738037,0.6743900775909424,500,adapt,flocet,1
StatlogGermanCredit,0.6679999828338623,1.3028976917266846,0.743401050567627,500,adapt,flocet,1
StatlogHeart,0.7910447716712952,0.48420119285583496,0.22753691673278809,500,adapt,flocet,1
StatlogImage,0.9012131690979004,4.098138809204102,2.1760964393615723,500,adapt,flocet,1
StatlogLandsat,0.8495000004768372,6.918219804763794,4.306650638580322,500,adapt,flocet,1
StatlogShuttle,0.8486207127571106,46.409380197525024,30.324527502059937,500,adapt,flocet,1
StatlogVehicle,0.5687204003334045,1.7365703582763672,0.32816076278686523,500,adapt,flocet,1
SteelPlates,0.5835051536560059,2.451498031616211,1.3010475635528564,500,adapt,flocet,1
SyntheticControl,0.800000011920929,1.2461390495300293,0.4061417579650879,500,adapt,flocet,1
Teaching,0.42105263471603394,0.24854350090026855,0.20552849769592285,500,adapt,flocet,1
Thyroid,0.9393232464790344,5.562290191650391,10.491874694824219,500,adapt,flocet,1
TicTacToe,0.8828451633453369,0.7999608516693115,0.3710472583770752,500,adapt,flocet,1
Titanic,0.7636363506317139,2.8984596729278564,1.781348466873169,500,adapt,flocet,1
Trains,1.0,0.018594741821289062,0.008596420288085938,500,adapt,flocet,1
Twonorm,0.9702702760696411,8.849219799041748,5.750366687774658,500,adapt,flocet,1
VertebralColumn2Clases,0.8181818127632141,0.6992957592010498,0.19969868659973145,500,adapt,flocet,1
VertebralColumn3Clases,0.4935064911842346,0.6953535079956055,0.2533550262451172,500,adapt,flocet,1
WallFollowing,0.8511730432510376,6.431565523147583,3.954218626022339,500,adapt,flocet,1
Waveform,0.7991999983787537,6.3238184452056885,3.4017832279205322,500,adapt,flocet,1
WaveformNoise,0.7847999930381775,9.135874271392822,3.142841100692749,500,adapt,flocet,1
Wine,0.9772727489471436,0.2840611934661865,0.06970763206481934,500,adapt,flocet,1
WineQualityRed,0.5674999952316284,1.9686393737792969,1.2262201309204102,500,adapt,flocet,1
WineQualityWhite,0.45996731519699097,6.491494417190552,3.239431619644165,500,adapt,flocet,1
Yeast,0.4285714328289032,2.297797918319702,0.6145932674407959,500,adapt,flocet,1
Zoo,1.0,0.2119448184967041,0.13571548461914062,500,adapt,flocet,1
Abalone,0.5842911601066589,5.338366270065308,2.2040224075317383,500,online,flocet,1
AcuteInflammation,1.0,0.25755786895751953,0.1587677001953125,500,online,flocet,1
AcuteNephritis,1.0,0.25380706787109375,0.16207504272460938,500,online,flocet,1
Adult,0.7935630679130554,53.98069500923157,40.125967502593994,500,online,flocet,1
Annealing,0.800000011920929,1.8700246810913086,0.15688133239746094,500,online,flocet,1
Arrhythmia,0.20353981852531433,0.9461166858673096,0.22953033447265625,500,online,flocet,1
AudiologyStd,0.6399999856948853,0.5227105617523193,0.053435564041137695,500,online,flocet,1
BalanceScale,0.8910256624221802,1.4634697437286377,0.42774534225463867,500,online,flocet,1
Balloons,0.75,0.015023946762084961,0.006901264190673828,500,online,flocet,1
Bank,0.8601769804954529,6.60783576965332,3.6043834686279297,500,online,flocet,1
Blood,0.6737967729568481,1.5602562427520752,0.4369361400604248,500,online,flocet,1
BreastCancer,0.5352112650871277,0.683539867401123,0.25290870666503906,500,online,flocet,1
BreastCancerWisc,0.954285740852356,1.0255918502807617,0.2715644836425781,500,online,flocet,1
BreastCancerWiscDiag,0.9154929518699646,1.2948622703552246,0.35503458976745605,500,online,flocet,1
BreastCancerWiscProg,0.6734693646430969,0.4732630252838135,0.2625243663787842,500,online,flocet,1
BreastTissue,0.7307692170143127,0.1279604434967041,0.041149139404296875,500,online,flocet,1
Car,0.8981481194496155,2.202908515930176,1.0947659015655518,500,online,flocet,1
Cardiotocography10Clases,0.6911487579345703,2.6780126094818115,1.2459299564361572,500,online,flocet,1
Cardiotocography3Clases,0.8248587846755981,3.628133535385132,2.7497129440307617,500,online,flocet,1
ChessKrvk,0.38964927196502686,39.332022190093994,16.98236918449402,500,online,flocet,1
ChessKrvkp,0.9386733174324036,3.7397594451904297,1.696852684020996,500,online,flocet,1
CongressionalVoting,0.60550457239151,0.4447596073150635,0.16905903816223145,500,online,flocet,1
ConnBenchSonarMinesRocks,0.7115384340286255,0.49713993072509766,0.16717767715454102,500,online,flocet,1
ConnBenchVowelDeterding,0.6839826703071594,1.023256540298462,1.0308408737182617,500,online,flocet,1
Connect4,0.7383503913879395,83.58106207847595,44.74614143371582,500,online,flocet,1
Contrac,0.489130437374115,2.074558734893799,1.1983952522277832,500,online,flocet,1
CreditApproval,0.8488371968269348,0.6563220024108887,0.26752614974975586,500,online,flocet,1
CylinderBands,0.5625,1.0997989177703857,0.21634292602539062,500,online,flocet,1
Dermatology,0.9230769276618958,0.6212499141693115,0.44883251190185547,500,online,flocet,1
Echocardiogram,0.8787878751754761,0.29253721237182617,0.17751598358154297,500,online,flocet,1
Ecoli,0.8333333134651184,0.5183744430541992,0.13091421127319336,500,online,flocet,1
EnergyY1,0.890625,1.7789552211761475,0.3013606071472168,500,online,flocet,1
EnergyY2,0.8125,1.0385637283325195,0.3388035297393799,500,online,flocet,1
Fertility,0.8799999952316284,0.23256492614746094,0.06803631782531738,500,online,flocet,1
Flags,0.4375,0.5300552845001221,0.2575111389160156,500,online,flocet,1
Glass,0.4716981053352356,0.557126522064209,0.28360724449157715,500,online,flocet,1
HabermanSurvival,0.6710526347160339,0.28318119049072266,0.12470126152038574,500,online,flocet,1
HayesRoth,0.6071428656578064,0.43440914154052734,0.15137982368469238,500,online,flocet,1
HeartCleveland,0.5526315569877625,0.8211395740509033,0.2707393169403076,500,online,flocet,1
HeartHungarian,0.4794520437717438,0.32158493995666504,0.11379671096801758,500,online,flocet,1
HeartSwitzerland,0.35483869910240173,0.34374380111694336,0.1678910255432129,500,online,flocet,1
HeartVa,0.2199999988079071,0.5668296813964844,0.2688591480255127,500,online,flocet,1
Hepatitis,0.8461538553237915,0.33756303787231445,0.06301164627075195,500,online,flocet,1
HillValley,0.5033003091812134,1.277409315109253,1.0497314929962158,500,online,flocet,1
HorseColic,0.720588207244873,0.9694216251373291,0.36623692512512207,500,online,flocet,1
IlpdIndianLiver,0.6712328791618347,0.5738999843597412,0.2265760898590088,500,online,flocet,1
ImageSegmentation,0.8409523963928223,0.6847162246704102,3.750606060028076,500,online,flocet,1
Ionosphere,0.9204545617103577,0.6810910701751709,0.29047131538391113,500,online,flocet,1
Iris,0.9459459185600281,0.3044750690460205,0.1987910270690918,500,online,flocet,1
LedDisplay,0.6800000071525574,0.8926694393157959,0.5255472660064697,500,online,flocet,1
Lenses,0.8333333134651184,0.04380917549133301,0.03174328804016113,500,online,flocet,1
Letter,0.7383999824523926,21.74596929550171,11.581705331802368,500,online,flocet,1
Libras,0.5222222208976746,0.7664132118225098,0.3195536136627197,500,online,flocet,1
LowResSpect,0.6090225577354431,0.4985630512237549,0.48095035552978516,500,online,flocet,1
LungCancer,0.125,0.06355047225952148,0.043912410736083984,500,online,flocet,1
Lymphography,0.7027027010917664,0.3454148769378662,0.1988368034362793,500,online,flocet,1
Magic,0.7695057988166809,20.380001544952393,10.508560419082642,500,online,flocet,1
Mammographic,0.7041666507720947,1.2369623184204102,0.3724803924560547,500,online,flocet,1
Miniboone,0.2855824828147888,157.31223821640015,72.48578929901123,500,online,flocet,1
MolecBiolPromoter,0.8461538553237915,0.09015631675720215,0.12001156806945801,500,online,flocet,1
MolecBiolSplice,0.7001254558563232,3.243932008743286,1.8029720783233643,500,online,flocet,1
Monks1,0.7546296119689941,0.3696763515472412,0.8539776802062988,500,online,flocet,1
Monks2,0.8634259104728699,0.3224449157714844,0.7509489059448242,500,online,flocet,1
Monks3,0.9282407164573669,0.2711763381958008,1.7749006748199463,500,online,flocet,1
Mushroom,0.9926144480705261,9.827688455581665,4.409945249557495,500,online,flocet,1
Musk1,0.6638655662536621,0.9404165744781494,0.18588733673095703,500,online,flocet,1
Musk2,0.8714372515678406,6.997838258743286,5.033830165863037,500,online,flocet,1
Nursery,0.9234567880630493,13.937711238861084,6.8954339027404785,500,online,flocet,1
OocytesMerlucciusNucleus4d,0.6000000238418579,0.8735306262969971,1.0686569213867188,500,online,flocet,1
OocytesMerlucciusStates2f,0.8784313797950745,0.8288421630859375,0.6249604225158691,500,online,flocet,1
OocytesTrisopterusNucleus2f,0.6666666865348816,0.9183623790740967,0.35410356521606445,500,online,flocet,1
OocytesTrisopterusStates5b,0.8157894611358643,0.770592451095581,0.67899489402771,500,online,flocet,1
Optical,0.8987200856208801,4.129638910293579,4.2725160121917725,500,online,flocet,1
Ozone,0.9700315594673157,2.612823486328125,1.2873215675354004,500,online,flocet,1
PageBlocks,0.9283625483512878,5.896868467330933,2.547316789627075,500,online,flocet,1
Parkinsons,0.8979591727256775,0.4454967975616455,0.26267337799072266,500,online,flocet,1
Pendigits,0.9293882250785828,8.204530954360962,7.288570165634155,500,online,flocet,1
Pima,0.7239583134651184,1.038752555847168,0.2962310314178467,500,online,flocet,1
PittsburgBridgesMaterial,0.8461538553237915,0.14243173599243164,0.04151439666748047,500,online,flocet,1
PittsburgBridgesRelL,0.6153846383094788,0.22400736808776855,0.14063262939453125,500,online,flocet,1
PittsburgBridgesSpan,0.695652186870575,0.19988012313842773,0.12442421913146973,500,online,flocet,1
PittsburgBridgesTOrD,0.800000011920929,0.24020004272460938,0.13692307472229004,500,online,flocet,1
PittsburgBridgesType,0.5769230723381042,0.2724747657775879,0.14060187339782715,500,online,flocet,1
Planning,0.42222222685813904,0.41988372802734375,0.08596944808959961,500,online,flocet,1
PlantMargin,0.4325000047683716,2.389495611190796,1.7222440242767334,500,online,flocet,1
PlantShape,0.23749999701976776,2.8868918418884277,1.2755370140075684,500,online,flocet,1
PlantTexture,0.5575000047683716,2.632657289505005,1.2738032341003418,500,online,flocet,1
PostOperative,0.3636363744735718,0.21625900268554688,0.11875247955322266,500,online,flocet,1
PrimaryTumor,0.353658527135849,0.7201569080352783,0.44068193435668945,500,online,flocet,1
Ringnorm,0.8783783912658691,8.164600372314453,4.604824781417847,500,online,flocet,1
Seeds,0.8846153616905212,0.3103773593902588,0.08147597312927246,500,online,flocet,1
Semeion,0.8065326809883118,3.073882579803467,1.9627137184143066,500,online,flocet,1
Soybean,0.8085106611251831,0.7375006675720215,1.1589248180389404,500,online,flocet,1
Spambase,0.7973912954330444,6.420749664306641,2.740121603012085,500,online,flocet,1
Spect,0.5913978219032288,0.1957230567932129,0.2904224395751953,500,online,flocet,1
Spectf,0.32620319724082947,0.20762944221496582,0.76934814453125,500,online,flocet,1
StatlogAustralianCredit,0.6279069781303406,1.1673462390899658,0.26793742179870605,500,online,flocet,1
StatlogGermanCredit,0.7160000205039978,1.4901692867279053,0.38797903060913086,500,online,flocet,1
StatlogHeart,0.7164179086685181,0.5599987506866455,0.1062004566192627,500,online,flocet,1
StatlogImage,0.8908145427703857,2.6504905223846436,0.899010181427002,500,online,flocet,1
StatlogLandsat,0.7455000281333923,6.167375564575195,4.238515377044678,500,online,flocet,1
StatlogShuttle,0.421448290348053,54.48470759391785,33.28644323348999,500,online,flocet,1
StatlogVehicle,0.6113743782043457,1.178300380706787,0.3289225101470947,500,online,flocet,1
SteelPlates,0.6350515484809875,2.725498676300049,0.8747766017913818,500,online,flocet,1
SyntheticControl,0.8066666722297668,0.8294670581817627,0.2333822250366211,500,online,flocet,1
Teaching,0.3947368562221527,0.24379563331604004,0.059601783752441406,500,online,flocet,1
Thyroid,0.9247374534606934,4.555510520935059,7.157354354858398,500,online,flocet,1
TicTacToe,0.9414225816726685,1.6284518241882324,0.3700392246246338,500,online,flocet,1
Titanic,0.6709091067314148,2.4355826377868652,2.2755770683288574,500,online,flocet,1
Trains,1.0,0.022577285766601562,0.00876164436340332,500,online,flocet,1
Twonorm,0.9475675821304321,7.653271436691284,4.228004217147827,500,online,flocet,1
VertebralColumn2Clases,0.8051947951316833,0.6554291248321533,0.12246155738830566,500,online,flocet,1
VertebralColumn3Clases,0.5584415793418884,0.6552655696868896,0.1282486915588379,500,online,flocet,1
WallFollowing,0.8922287225723267,5.986451864242554,3.674078941345215,500,online,flocet,1
Waveform,0.769599974155426,6.040835380554199,3.405418634414673,500,online,flocet,1
WaveformNoise,0.7504000067710876,6.919350862503052,4.054136753082275,500,online,flocet,1
Wine,0.9090909361839294,0.3893289566040039,0.23798704147338867,500,online,flocet,1
WineQualityRed,0.5450000166893005,2.039503574371338,1.4585514068603516,500,online,flocet,1
WineQualityWhite,0.37336599826812744,9.807344436645508,4.092297792434692,500,online,flocet,1
Yeast,0.4366576671600342,2.2202694416046143,1.1747543811798096,500,online,flocet,1
Zoo,0.8399999737739563,0.1729295253753662,0.13637089729309082,500,online,flocet,1
Abalone,0.5756704807281494,6.5288002490997314,3.308683156967163,500,adjust,flocet,1
AcuteInflammation,1.0,0.22534584999084473,0.04884457588195801,500,adjust,flocet,1
AcuteNephritis,1.0,0.2616541385650635,0.16140007972717285,500,adjust,flocet,1
Adult,0.7998894453048706,59.24691081047058,65.69212460517883,500,adjust,flocet,1
Annealing,0.8399999737739563,2.1481375694274902,0.41959667205810547,500,adjust,flocet,1
Arrhythmia,0.3539822995662689,0.7493197917938232,0.6041281223297119,500,adjust,flocet,1
AudiologyStd,0.5600000023841858,0.5585601329803467,0.07526087760925293,500,adjust,flocet,1
BalanceScale,0.9038461446762085,1.4311294555664062,0.3281514644622803,500,adjust,flocet,1
Balloons,0.75,0.030261993408203125,0.02247023582458496,500,adjust,flocet,1
Bank,0.8637168407440186,10.001539468765259,4.999488592147827,500,adjust,flocet,1
Blood,0.6844919919967651,1.804288387298584,0.8890256881713867,500,adjust,flocet,1
BreastCancer,0.6197183132171631,0.7567732334136963,0.2699415683746338,500,adjust,flocet,1
BreastCancerWisc,0.9828571677207947,1.6379895210266113,0.7827577590942383,500,adjust,flocet,1
BreastCancerWiscDiag,0.9507042169570923,1.275132656097412,0.6465332508087158,500,adjust,flocet,1
BreastCancerWiscProg,0.7142857313156128,0.38228940963745117,0.07640886306762695,500,adjust,flocet,1
BreastTissue,0.6538461446762085,0.208296537399292,0.1406996250152588,500,adjust,flocet,1
Car,0.9120370149612427,3.6749672889709473,1.8234457969665527,500,adjust,flocet,1
Cardiotocography10Clases,0.7532956600189209,4.453390836715698,1.9557476043701172,500,adjust,flocet,1
Cardiotocography3Clases,0.903954803943634,4.299968004226685,2.2624526023864746,500,adjust,flocet,1
ChessKrvk,0.38964927196502686,74.52708983421326,33.14066529273987,500,adjust,flocet,1
ChessKrvkp,0.9073842167854309,7.255139589309692,3.983977794647217,500,adjust,flocet,1
CongressionalVoting,0.6238532066345215,1.1892063617706299,0.580209493637085,500,adjust,flocet,1
ConnBenchSonarMinesRocks,0.75,0.48507070541381836,0.2803518772125244,500,adjust,flocet,1
ConnBenchVowelDeterding,0.7229437232017517,1.4130795001983643,2.2648446559906006,500,adjust,flocet,1
Connect4,0.7279886603355408,142.9152934551239,67.17529034614563,500,adjust,flocet,1
Contrac,0.42391303181648254,4.300392150878906,1.9140288829803467,500,adjust,flocet,1
CreditApproval,0.8255813717842102,1.4425263404846191,0.2674086093902588,500,adjust,flocet,1
CylinderBands,0.640625,0.9864814281463623,0.23592257499694824,500,adjust,flocet,1
Dermatology,0.9890109896659851,0.9027740955352783,0.343273401260376,500,adjust,flocet,1
Echocardiogram,0.8484848737716675,0.27079319953918457,0.17688608169555664,500,adjust,flocet,1
Ecoli,0.8333333134651184,0.5855228900909424,0.1760234832763672,500,adjust,flocet,1
EnergyY1,0.8697916865348816,1.5391409397125244,1.0052435398101807,500,adjust,flocet,1
EnergyY2,0.9010416865348816,1.7693192958831787,0.8920645713806152,500,adjust,flocet,1
Fertility,0.7200000286102295,0.19050836563110352,0.1352553367614746,500,adjust,flocet,1
Flags,0.5208333134651184,0.23128914833068848,0.16014337539672852,500,adjust,flocet,1
Glass,0.30188679695129395,0.5736939907073975,0.15060830116271973,500,adjust,flocet,1
HabermanSurvival,0.6578947305679321,0.7913045883178711,0.38601255416870117,500,adjust,flocet,1
HayesRoth,0.8214285969734192,0.43840956687927246,0.15101194381713867,500,adjust,flocet,1
HeartCleveland,0.5,0.8445723056793213,0.31650733947753906,500,adjust,flocet,1
HeartHungarian,0.8219178318977356,0.7640719413757324,0.2383885383605957,500,adjust,flocet,1
HeartSwitzerland,0.25806450843811035,0.1966838836669922,0.048895835876464844,500,adjust,flocet,1
HeartVa,0.2199999988079071,0.6212120056152344,0.11114168167114258,500,adjust,flocet,1
Hepatitis,0.8717948794364929,0.37203454971313477,0.20934557914733887,500,adjust,flocet,1
HillValley,0.5231022834777832,1.9206268787384033,2.540325403213501,500,adjust,flocet,1
HorseColic,0.720588207244873,0.8233311176300049,0.10626053810119629,500,adjust,flocet,1
IlpdIndianLiver,0.6849315166473389,1.2999138832092285,0.6150155067443848,500,adjust,flocet,1
ImageSegmentation,0.8609523773193359,0.738426685333252,7.77579665184021,500,adjust,flocet,1
Ionosphere,0.8977272510528564,0.5379257202148438,0.4330148696899414,500,adjust,flocet,1
Iris,0.9459459185600281,0.3615455627441406,0.19448208808898926,500,adjust,flocet,1
LedDisplay,0.7599999904632568,1.872124433517456,1.053175687789917,500,adjust,flocet,1
Lenses,0.8333333134651184,0.04251575469970703,0.033677101135253906,500,adjust,flocet,1
Letter,0.6952000260353088,34.63748478889465,12.772331476211548,500,adjust,flocet,1
Libras,0.5222222208976746,0.4845094680786133,0.4887683391571045,500,adjust,flocet,1
LowResSpect,0.8345864415168762,0.8096206188201904,0.3526451587677002,500,adjust,flocet,1
LungCancer,0.25,0.03959345817565918,0.015274286270141602,500,adjust,flocet,1
Lymphography,0.7837837934494019,0.3738398551940918,0.1993248462677002,500,adjust,flocet,1
Magic,0.7541535496711731,22.583738088607788,9.975261688232422,500,adjust,flocet,1
Mammographic,0.762499988079071,1.1591076850891113,0.3729100227355957,500,adjust,flocet,1
Miniboone,0.28444457054138184,152.91466426849365,77.82973122596741,500,adjust,flocet,1
MolecBiolPromoter,0.7307692170143127,0.20698165893554688,0.06251311302185059,500,adjust,flocet,1
MolecBiolSplice,0.6737766861915588,3.8148036003112793,2.1742682456970215,500,adjust,flocet,1
Monks1,0.6481481194496155,0.41843748092651367,1.8141109943389893,500,adjust,flocet,1
Monks2,0.9027777910232544,0.5010890960693359,0.6704423427581787,500,adjust,flocet,1
Monks3,0.9097222089767456,0.2850031852722168,1.1004552841186523,500,adjust,flocet,1
Mushroom,0.9960610270500183,7.261662244796753,3.693277359008789,500,adjust,flocet,1
Musk1,0.6722689270973206,1.0341057777404785,0.41223716735839844,500,adjust,flocet,1
Musk2,0.926622211933136,8.994165658950806,4.158301115036011,500,adjust,flocet,1
Nursery,0.9299382567405701,15.65798306465149,7.53034520149231,500,adjust,flocet,1
OocytesMerlucciusNucleus4d,0.6784313917160034,1.0814502239227295,0.3949732780456543,500,adjust,flocet,1
OocytesMerlucciusStates2f,0.8784313797950745,1.5086455345153809,0.5013887882232666,500,adjust,flocet,1
OocytesTrisopterusNucleus2f,0.6491228342056274,1.2589020729064941,0.3536951541900635,500,adjust,flocet,1
OocytesTrisopterusStates5b,0.8333333134651184,1.4050676822662354,0.5733366012573242,500,adjust,flocet,1
Optical,0.9115191698074341,8.277144432067871,5.400931119918823,500,adjust,flocet,1
Ozone,0.9558359384536743,3.577100992202759,0.979478120803833,500,adjust,flocet,1
PageBlocks,0.9086257219314575,5.826460361480713,2.7521419525146484,500,adjust,flocet,1
Parkinsons,0.7551020383834839,0.20619440078735352,0.07612276077270508,500,adjust,flocet,1
Pendigits,0.9365351796150208,9.480346441268921,7.544701814651489,500,adjust,flocet,1
Pima,0.6979166865348816,1.1187365055084229,0.29584383964538574,500,adjust,flocet,1
PittsburgBridgesMaterial,0.9230769276618958,0.17656254768371582,0.10437917709350586,500,adjust,flocet,1
PittsburgBridgesRelL,0.3461538553237915,0.23685407638549805,0.13996434211730957,500,adjust,flocet,1
PittsburgBridgesSpan,0.6521739363670349,0.2216339111328125,0.12444186210632324,500,adjust,flocet,1
PittsburgBridgesTOrD,0.7599999904632568,0.24550223350524902,0.05115389823913574,500,adjust,flocet,1
PittsburgBridgesType,0.4615384638309479,0.26267051696777344,0.1405017375946045,500,adjust,flocet,1
Planning,0.5555555820465088,0.40124082565307617,0.07114672660827637,500,adjust,flocet,1
PlantMargin,0.5525000095367432,3.152653694152832,0.6210875511169434,500,adjust,flocet,1
PlantShape,0.2574999928474426,4.309966802597046,1.8651494979858398,500,adjust,flocet,1
PlantTexture,0.5350000262260437,3.1558263301849365,0.620314359664917,500,adjust,flocet,1
PostOperative,0.22727273404598236,0.18891453742980957,0.1194772720336914,500,adjust,flocet,1
PrimaryTumor,0.2804878056049347,0.983757734298706,0.4390442371368408,500,adjust,flocet,1
Ringnorm,0.9059459567070007,12.594046354293823,5.8470799922943115,500,adjust,flocet,1
Seeds,0.8461538553237915,0.4728555679321289,0.2814826965332031,500,adjust,flocet,1
Semeion,0.839195966720581,1.8119049072265625,1.3064541816711426,500,adjust,flocet,1
Soybean,0.8164893388748169,0.8118963241577148,1.6146302223205566,500,adjust,flocet,1
Spambase,0.7991304397583008,6.455671548843384,4.696755886077881,500,adjust,flocet,1
Spect,0.6344085931777954,0.23922467231750488,0.7712862491607666,500,adjust,flocet,1
Spectf,0.34224599599838257,0.26598215103149414,0.7329273223876953,500,adjust,flocet,1
StatlogAustralianCredit,0.645348846912384,1.9087212085723877,0.2694664001464844,500,adjust,flocet,1
StatlogGermanCredit,0.7360000014305115,1.9473862648010254,0.38832545280456543,500,adjust,flocet,1
StatlogHeart,0.7761194109916687,0.6364529132843018,0.3588521480560303,500,adjust,flocet,1
StatlogImage,0.9202772974967957,2.710665464401245,1.4039878845214844,500,adjust,flocet,1
StatlogLandsat,0.8149999976158142,7.394550323486328,5.239432096481323,500,adjust,flocet,1
StatlogShuttle,0.6133103370666504,69.06449604034424,39.27758836746216,500,adjust,flocet,1
StatlogVehicle,0.5829383730888367,1.1505749225616455,0.6816356182098389,500,adjust,flocet,1
SteelPlates,0.6350515484809875,2.200350522994995,1.7697548866271973,500,adjust,flocet,1
SyntheticControl,0.8533333539962769,1.4004459381103516,0.4932990074157715,500,adjust,flocet,1
Teaching,0.5789473652839661,0.2149217128753662,0.20505523681640625,500,adjust,flocet,1
Thyroid,0.8649358153343201,6.744683742523193,9.25260877609253,500,adjust,flocet,1
TicTacToe,0.9414225816726685,1.5021791458129883,0.37372875213623047,500,adjust,flocet,1
Titanic,0.7818182110786438,3.064321994781494,1.697416067123413,500,adjust,flocet,1
Trains,0.5,0.02402973175048828,0.008475780487060547,500,adjust,flocet,1
Twonorm,0.9281080961227417,10.014387369155884,5.036700248718262,500,adjust,flocet,1
VertebralColumn2Clases,0.7922077775001526,0.666426420211792,0.12014389038085938,500,adjust,flocet,1
VertebralColumn3Clases,0.5064935088157654,0.7153117656707764,0.12053990364074707,500,adjust,flocet,1
WallFollowing,0.8995600938796997,6.237671136856079,2.9267756938934326,500,adjust,flocet,1
Waveform,0.8312000036239624,5.9879841804504395,2.92037296295166,500,adjust,flocet,1
WaveformNoise,0.7991999983787537,7.620661497116089,5.555128574371338,500,adjust,flocet,1
Wine,0.9545454382896423,0.3836476802825928,0.07113790512084961,500,adjust,flocet,1
WineQualityRed,0.5099999904632568,2.262033700942993,0.9751477241516113,500,adjust,flocet,1
WineQualityWhite,0.4248366057872772,10.061224460601807,3.2503488063812256,500,adjust,flocet,1
Yeast,0.5256064534187317,2.494830369949341,0.5955095291137695,500,adjust,flocet,1
Zoo,0.9599999785423279,0.2314929962158203,0.09942340850830078,500,adjust,flocet,1
Abalone,0.5344827771186829,6.292515277862549,2.3026297092437744,200,adapt,flocet,1
AcuteInflammation,1.0,0.241347074508667,0.12596607208251953,200,adapt,flocet,1
AcuteNephritis,1.0,0.23413395881652832,0.16118526458740234,200,adapt,flocet,1
Adult,0.7584915161132812,45.3204927444458,33.466798543930054,200,adapt,flocet,1
Annealing,0.8600000143051147,1.0586130619049072,0.15568161010742188,200,adapt,flocet,1
Arrhythmia,0.3097345232963562,1.1228153705596924,0.22935032844543457,200,adapt,flocet,1
AudiologyStd,0.5600000023841858,0.5446250438690186,0.13756680488586426,200,adapt,flocet,1
BalanceScale,0.8782051205635071,1.2063703536987305,0.24106812477111816,200,adapt,flocet,1
Balloons,0.25,0.024938583374023438,0.012901782989501953,200,adapt,flocet,1
Bank,0.8734513521194458,4.434070110321045,2.358137845993042,200,adapt,flocet,1
Blood,0.7540106773376465,1.0506010055541992,0.2918813228607178,200,adapt,flocet,1
BreastCancer,0.6197183132171631,0.6378815174102783,0.38019490242004395,200,adapt,flocet,1
BreastCancerWisc,0.9142857193946838,0.6111915111541748,0.2722940444946289,200,adapt,flocet,1
BreastCancerWiscDiag,0.908450722694397,1.2671384811401367,0.3753795623779297,200,adapt,flocet,1
BreastCancerWiscProg,0.795918345451355,0.4507899284362793,0.2648184299468994,200,adapt,flocet,1
BreastTissue,0.7307692170143127,0.24919581413269043,0.1409745216369629,200,adapt,flocet,1
Car,0.8657407164573669,1.6534905433654785,0.6698954105377197,200,adapt,flocet,1
Cardiotocography10Clases,0.6007533073425293,3.5729713439941406,1.3478198051452637,200,adapt,flocet,1
Cardiotocography3Clases,0.8512241244316101,1.806593894958496,1.0861732959747314,200,adapt,flocet,1
ChessKrvk,0.3297690451145172,31.117756366729736,20.987180709838867,200,adapt,flocet,1
ChessKrvkp,0.8998748660087585,5.278426885604858,2.2194557189941406,200,adapt,flocet,1
CongressionalVoting,0.60550457239151,0.7840316295623779,0.16881918907165527,200,adapt,flocet,1
ConnBenchSonarMinesRocks,0.6538461446762085,0.46232151985168457,0.28424859046936035,200,adapt,flocet,1
ConnBenchVowelDeterding,0.6601731777191162,1.1795248985290527,1.8113322257995605,200,adapt,flocet,1
Connect4,0.6464563012123108,58.2770209312439,45.58709454536438,200,adapt,flocet,1
Contrac,0.45108696818351746,2.221128463745117,1.770338773727417,200,adapt,flocet,1
CreditApproval,0.8139534592628479,1.0417251586914062,0.646233320236206,200,adapt,flocet,1
CylinderBands,0.5859375,0.4861173629760742,0.19919705390930176,200,adapt,flocet,1
Dermatology,0.8461538553237915,0.7964355945587158,0.48967647552490234,200,adapt,flocet,1
Echocardiogram,0.8787878751754761,0.21419906616210938,0.08301997184753418,200,adapt,flocet,1
Ecoli,0.738095223903656,0.7731101512908936,0.2607543468475342,200,adapt,flocet,1
EnergyY1,0.890625,0.9416265487670898,0.4089517593383789,200,adapt,flocet,1
EnergyY2,0.6770833134651184,1.5124640464782715,0.30741429328918457,200,adapt,flocet,1
Fertility,0.6000000238418579,0.23621082305908203,0.08201742172241211,200,adapt,flocet,1
Flags,0.4375,0.27963972091674805,0.07515573501586914,200,adapt,flocet,1
Glass,0.2830188572406769,0.5026688575744629,0.28510499000549316,200,adapt,flocet,1
HabermanSurvival,0.6973684430122375,0.6884689331054688,0.4081990718841553,200,adapt,flocet,1
HayesRoth,0.4642857015132904,0.3962275981903076,0.15188932418823242,200,adapt,flocet,1
HeartCleveland,0.5789473652839661,0.5774261951446533,0.11861252784729004,200,adapt,flocet,1
HeartHungarian,0.5205479264259338,0.6755688190460205,0.2994997501373291,200,adapt,flocet,1
HeartSwitzerland,0.4193548262119293,0.3049345016479492,0.16750884056091309,200,adapt,flocet,1
HeartVa,0.25999999046325684,0.37100648880004883,0.26871585845947266,200,adapt,flocet,1
Hepatitis,0.5641025900840759,0.3444192409515381,0.2119922637939453,200,adapt,flocet,1
HillValley,0.5099009871482849,1.7240924835205078,2.1037988662719727,200,adapt,flocet,1
HorseColic,0.6764705777168274,0.7074217796325684,0.3682372570037842,200,adapt,flocet,1
IlpdIndianLiver,0.7191780805587769,1.316892385482788,0.5774831771850586,200,adapt,flocet,1
ImageSegmentation,0.7576190233230591,0.3293650150299072,6.304642200469971,200,adapt,flocet,1
Ionosphere,0.875,0.6168301105499268,0.4698667526245117,200,adapt,flocet,1
Iris,0.9189189076423645,0.2926604747772217,0.18060016632080078,200,adapt,flocet,1
LedDisplay,0.6759999990463257,1.7551589012145996,0.3866119384765625,200,adapt,flocet,1
Lenses,0.6666666865348816,0.04134988784790039,0.02112555503845215,200,adapt,flocet,1
Letter,0.5613999962806702,23.822000980377197,12.269510984420776,200,adapt,flocet,1
Libras,0.35555556416511536,0.7989842891693115,0.4848165512084961,200,adapt,flocet,1
LowResSpect,0.7218044996261597,1.0529837608337402,0.3275318145751953,200,adapt,flocet,1
LungCancer,0.375,0.0510869026184082,0.025011539459228516,200,adapt,flocet,1
Lymphography,0.8918918967247009,0.3345625400543213,0.17801189422607422,200,adapt,flocet,1
Magic,0.794532060623169,20.331042528152466,10.566311120986938,200,adapt,flocet,1
Mammographic,0.7583333253860474,0.8683922290802002,0.37496471405029297,200,adapt,flocet,1
Miniboone,0.7280108332633972,114.53056359291077,79.55927443504333,200,adapt,flocet,1
MolecBiolPromoter,0.8461538553237915,0.18438506126403809,0.062470436096191406,200,adapt,flocet,1
MolecBiolSplice,0.6022584438323975,3.1280744075775146,3.2773468494415283,200,adapt,flocet,1
Monks1,0.6388888955116272,0.3464500904083252,1.3338158130645752,200,adapt,flocet,1
Monks2,0.8796296119689941,0.501291036605835,0.8891544342041016,200,adapt,flocet,1
Monks3,0.8402777910232544,0.27930235862731934,0.6664304733276367,200,adapt,flocet,1
Mushroom,0.9940915703773499,7.394102096557617,4.422163009643555,200,adapt,flocet,1
Musk1,0.6134454011917114,0.6774883270263672,0.18547558784484863,200,adapt,flocet,1
Musk2,0.8835657835006714,5.421646595001221,3.0014572143554688,200,adapt,flocet,1
Nursery,0.8839505910873413,11.11426067352295,6.288730144500732,200,adapt,flocet,1
OocytesMerlucciusNucleus4d,0.5254902243614197,2.2645552158355713,0.396500825881958,200,adapt,flocet,1
OocytesMerlucciusStates2f,0.8274509906768799,1.0666625499725342,0.3965599536895752,200,adapt,flocet,1
OocytesTrisopterusNucleus2f,0.6008771657943726,0.7411291599273682,0.35541367530822754,200,adapt,flocet,1
OocytesTrisopterusStates5b,0.8508771657943726,1.981698751449585,0.3543128967285156,200,adapt,flocet,1
Optical,0.8675570487976074,5.097001552581787,4.777279615402222,200,adapt,flocet,1
Ozone,0.9716088175773621,2.8437910079956055,1.4498536586761475,200,adapt,flocet,1
PageBlocks,0.9093567132949829,6.2541468143463135,3.2190966606140137,200,adapt,flocet,1
Parkinsons,0.8571428656578064,0.4243581295013428,0.2622647285461426,200,adapt,flocet,1
Pendigits,0.8916523456573486,9.181769371032715,7.019122123718262,200,adapt,flocet,1
Pima,0.6822916865348816,0.9249136447906494,0.2965116500854492,200,adapt,flocet,1
PittsburgBridgesMaterial,0.8846153616905212,0.17343449592590332,0.14091730117797852,200,adapt,flocet,1
PittsburgBridgesRelL,0.6153846383094788,0.20826125144958496,0.14060711860656738,200,adapt,flocet,1
PittsburgBridgesSpan,0.5652173757553101,0.15278840065002441,0.12525248527526855,200,adapt,flocet,1
PittsburgBridgesTOrD,0.8799999952316284,0.21998381614685059,0.13548898696899414,200,adapt,flocet,1
PittsburgBridgesType,0.6153846383094788,0.1493673324584961,0.04171419143676758,200,adapt,flocet,1
Planning,0.5777778029441833,0.41252732276916504,0.24332809448242188,200,adapt,flocet,1
PlantMargin,0.3075000047683716,2.037278413772583,0.8079380989074707,200,adapt,flocet,1
PlantShape,0.13249999284744263,2.3768844604492188,0.6224536895751953,200,adapt,flocet,1
PlantTexture,0.1899999976158142,2.0795352458953857,0.6899363994598389,200,adapt,flocet,1
PostOperative,0.3181818127632141,0.12996339797973633,0.1189110279083252,200,adapt,flocet,1
PrimaryTumor,0.37804877758026123,0.3446180820465088,0.1270601749420166,200,adapt,flocet,1
Ringnorm,0.8329729437828064,6.922786474227905,5.276673316955566,200,adapt,flocet,1
Seeds,0.9230769276618958,0.40887999534606934,0.0839383602142334,200,adapt,flocet,1
Semeion,0.7386934757232666,2.2698142528533936,0.6194126605987549,200,adapt,flocet,1
Soybean,0.7739361524581909,0.9053263664245605,1.2506604194641113,200,adapt,flocet,1
Spambase,0.7234782576560974,4.881349325180054,2.9016668796539307,200,adapt,flocet,1
Spect,0.6290322542190552,0.22910046577453613,0.997154712677002,200,adapt,flocet,1
Spectf,0.8770053386688232,0.17883014678955078,0.4529731273651123,200,adapt,flocet,1
StatlogAustralianCredit,0.5988371968269348,1.63767671585083,0.4502286911010742,200,adapt,flocet,1
StatlogGermanCredit,0.6240000128746033,1.9519155025482178,0.3878645896911621,200,adapt,flocet,1
StatlogHeart,0.7761194109916687,0.6085011959075928,0.3597373962402344,200,adapt,flocet,1
StatlogImage,0.8734835386276245,4.05875301361084,1.1528956890106201,200,adapt,flocet,1
StatlogLandsat,0.8370000123977661,6.502573490142822,3.313821792602539,200,adapt,flocet,1
StatlogShuttle,0.5633103251457214,52.93657374382019,33.88516855239868,200,adapt,flocet,1
StatlogVehicle,0.4739336371421814,1.5749571323394775,0.32852649688720703,200,adapt,flocet,1
SteelPlates,0.5793814659118652,3.7718443870544434,0.7534122467041016,200,adapt,flocet,1
SyntheticControl,0.8733333349227905,0.9435606002807617,0.23324084281921387,200,adapt,flocet,1
Teaching,0.3947368562221527,0.14799785614013672,0.20450735092163086,200,adapt,flocet,1
Thyroid,0.8124270439147949,6.069780349731445,8.941515445709229,200,adapt,flocet,1
TicTacToe,0.8326359987258911,0.7639737129211426,0.37181973457336426,200,adapt,flocet,1
Titanic,0.7599999904632568,2.4091129302978516,1.368514060974121,200,adapt,flocet,1
Trains,0.5,0.01962113380432129,0.008939027786254883,200,adapt,flocet,1
Twonorm,0.9378378391265869,7.100908517837524,4.70380425453186,200,adapt,flocet,1
VertebralColumn2Clases,0.701298713684082,0.6976513862609863,0.41408610343933105,200,adapt,flocet,1
VertebralColumn3Clases,0.6623376607894897,0.5855426788330078,0.41469550132751465,200,adapt,flocet,1
WallFollowing,0.7844575047492981,8.405537843704224,3.3115925788879395,200,adapt,flocet,1
Waveform,0.7519999742507935,5.631614685058594,3.56213641166687,200,adapt,flocet,1
WaveformNoise,0.7552000284194946,7.008304595947266,3.911418914794922,200,adapt,flocet,1
Wine,0.8409090638160706,0.20222997665405273,0.0685734748840332,200,adapt,flocet,1
WineQualityRed,0.5249999761581421,2.881629228591919,1.2726240158081055,200,adapt,flocet,1
WineQualityWhite,0.4313725531101227,7.176578760147095,3.5354957580566406,200,adapt,flocet,1
Yeast,0.4420485198497772,2.417133092880249,1.2383527755737305,200,adapt,flocet,1
Zoo,0.8799999952316284,0.21421360969543457,0.04676413536071777,200,adapt,flocet,1
Abalone,0.5555555820465088,5.723097085952759,3.4496841430664062,200,online,flocet,1
AcuteInflammation,1.0,0.25156736373901367,0.1630229949951172,200,online,flocet,1
AcuteNephritis,1.0,0.24599027633666992,0.15886926651000977,200,online,flocet,1
Adult,0.7833057045936584,49.8093798160553,34.1060688495636,200,online,flocet,1
Annealing,0.7400000095367432,1.4912207126617432,0.2914259433746338,200,online,flocet,1
Arrhythmia,0.1504424810409546,0.9789981842041016,0.18167614936828613,200,online,flocet,1
AudiologyStd,0.6000000238418579,0.5900804996490479,0.09034204483032227,200,online,flocet,1
BalanceScale,0.8653846383094788,1.3335063457489014,0.6915743350982666,200,online,flocet,1
Balloons,0.75,0.029937028884887695,0.01944255828857422,200,online,flocet,1
Bank,0.8327433466911316,5.931477308273315,4.304229021072388,200,online,flocet,1
Blood,0.6951871514320374,1.5982024669647217,0.6947715282440186,200,online,flocet,1
BreastCancer,0.6760563254356384,0.3038809299468994,0.22501444816589355,200,online,flocet,1
BreastCancerWisc,0.9371428489685059,0.9164190292358398,0.2707374095916748,200,online,flocet,1
BreastCancerWiscDiag,0.9436619877815247,0.9300415515899658,0.4704093933105469,200,online,flocet,1
BreastCancerWiscProg,0.6326530575752258,0.19918370246887207,0.07624959945678711,200,online,flocet,1
BreastTissue,0.5769230723381042,0.22467517852783203,0.05722689628601074,200,online,flocet,1
Car,0.8796296119689941,2.4023725986480713,1.3710136413574219,200,online,flocet,1
Cardiotocography10Clases,0.6629002094268799,4.010733604431152,0.8764216899871826,200,online,flocet,1
Cardiotocography3Clases,0.8625235557556152,2.004974365234375,1.6824517250061035,200,online,flocet,1
ChessKrvk,0.37710294127464294,33.1041784286499,14.041961193084717,200,online,flocet,1
ChessKrvkp,0.8823529481887817,3.071331024169922,1.4917776584625244,200,online,flocet,1
CongressionalVoting,0.35779815912246704,0.43993496894836426,0.1684410572052002,200,online,flocet,1
ConnBenchSonarMinesRocks,0.7307692170143127,0.42036986351013184,0.08319282531738281,200,online,flocet,1
ConnBenchVowelDeterding,0.6623376607894897,1.2638206481933594,0.971099853515625,200,online,flocet,1
Connect4,0.7062585353851318,66.47661876678467,35.662198305130005,200,online,flocet,1
Contrac,0.44565218687057495,1.608931541442871,0.6857259273529053,200,online,flocet,1
CreditApproval,0.819767415523529,1.099355697631836,0.26654767990112305,200,online,flocet,1
CylinderBands,0.5859375,0.757004976272583,0.19998669624328613,200,online,flocet,1
Dermatology,0.9560439586639404,0.4218592643737793,0.14182519912719727,200,online,flocet,1
Echocardiogram,0.8484848737716675,0.302518367767334,0.17800021171569824,200,online,flocet,1
Ecoli,0.8214285969734192,0.5799190998077393,0.1311500072479248,200,online,flocet,1
EnergyY1,0.765625,1.0564854145050049,0.7029848098754883,200,online,flocet,1
EnergyY2,0.84375,1.0679359436035156,0.2980062961578369,200,online,flocet,1
Fertility,0.8399999737739563,0.2135322093963623,0.13521361351013184,200,online,flocet,1
Flags,0.4166666567325592,0.31751537322998047,0.0746462345123291,200,online,flocet,1
Glass,0.2830188572406769,0.536005973815918,0.28395986557006836,200,online,flocet,1
HabermanSurvival,0.6184210777282715,0.7732694149017334,0.2750434875488281,200,online,flocet,1
HayesRoth,0.6428571343421936,0.4057292938232422,0.1530776023864746,200,online,flocet,1
HeartCleveland,0.43421053886413574,0.4903452396392822,0.11812615394592285,200,online,flocet,1
HeartHungarian,0.6712328791618347,0.6625087261199951,0.16510438919067383,200,online,flocet,1
HeartSwitzerland,0.32258063554763794,0.32620930671691895,0.1671767234802246,200,online,flocet,1
HeartVa,0.2800000011920929,0.44876956939697266,0.07784414291381836,200,online,flocet,1
Hepatitis,0.7692307829856873,0.3596208095550537,0.20948410034179688,200,online,flocet,1
HillValley,0.5066006779670715,0.7628757953643799,1.6597585678100586,200,online,flocet,1
HorseColic,0.7352941036224365,0.8673512935638428,0.10638880729675293,200,online,flocet,1
IlpdIndianLiver,0.6164383292198181,1.0195372104644775,0.22763872146606445,200,online,flocet,1
ImageSegmentation,0.8023809790611267,0.5973351001739502,3.6501543521881104,200,online,flocet,1
Ionosphere,0.8181818127632141,0.3717153072357178,0.13795113563537598,200,online,flocet,1
Iris,0.9729729890823364,0.32959699630737305,0.19990992546081543,200,online,flocet,1
LedDisplay,0.699999988079071,0.931520938873291,0.574383020401001,200,online,flocet,1
Lenses,0.8333333134651184,0.045473575592041016,0.030692577362060547,200,online,flocet,1
Letter,0.6539999842643738,17.395918130874634,8.932042121887207,200,online,flocet,1
Libras,0.5444444417953491,0.9388248920440674,0.17279052734375,200,online,flocet,1
LowResSpect,0.8120300769805908,0.9755897521972656,0.20772647857666016,200,online,flocet,1
LungCancer,0.375,0.05502033233642578,0.025804519653320312,200,online,flocet,1
Lymphography,0.6756756901741028,0.3583638668060303,0.1914839744567871,200,online,flocet,1
Magic,0.653838038444519,19.410592317581177,13.18281078338623,200,online,flocet,1
Mammographic,0.6458333134651184,1.7008895874023438,1.2622034549713135,200,online,flocet,1
Miniboone,0.28444457054138184,151.94014692306519,67.33350825309753,200,online,flocet,1
MolecBiolPromoter,0.8846153616905212,0.20673894882202148,0.13559341430664062,200,online,flocet,1
MolecBiolSplice,0.5696361064910889,3.9500341415405273,2.9902360439300537,200,online,flocet,1
Monks1,0.6504629850387573,0.4004991054534912,1.2155697345733643,200,online,flocet,1
Monks2,0.7453703880310059,0.4098479747772217,1.123807668685913,200,online,flocet,1
Monks3,0.8240740895271301,0.37427735328674316,1.216240644454956,200,online,flocet,1
Mushroom,0.987690806388855,9.034611463546753,5.33677077293396,200,online,flocet,1
Musk1,0.5210084319114685,0.8173272609710693,0.18563508987426758,200,online,flocet,1
Musk2,0.864766538143158,7.87079119682312,4.366930723190308,200,online,flocet,1
Nursery,0.9179012179374695,16.006108283996582,7.250054121017456,200,online,flocet,1
OocytesMerlucciusNucleus4d,0.6509804129600525,2.2003440856933594,0.9288492202758789,200,online,flocet,1
OocytesMerlucciusStates2f,0.8313725590705872,0.959956169128418,0.39577341079711914,200,online,flocet,1
OocytesTrisopterusNucleus2f,0.640350878238678,1.3172998428344727,0.5894749164581299,200,online,flocet,1
OocytesTrisopterusStates5b,0.8289473652839661,1.3892991542816162,0.6492516994476318,200,online,flocet,1
Optical,0.8703394532203674,7.975869178771973,6.2672460079193115,200,online,flocet,1
Ozone,0.9684542417526245,3.4074838161468506,1.401658535003662,200,online,flocet,1
PageBlocks,0.8567251563072205,5.290869951248169,2.743345022201538,200,online,flocet,1
Parkinsons,0.8571428656578064,0.44672226905822754,0.26313257217407227,200,online,flocet,1
Pendigits,0.9110920429229736,9.887086868286133,6.643522500991821,200,online,flocet,1
Pima,0.703125,0.8839900493621826,0.46039676666259766,200,online,flocet,1
PittsburgBridgesMaterial,0.8846153616905212,0.12987971305847168,0.041762590408325195,200,online,flocet,1
PittsburgBridgesRelL,0.692307710647583,0.22117853164672852,0.1408073902130127,200,online,flocet,1
PittsburgBridgesSpan,0.695652186870575,0.17505884170532227,0.12486076354980469,200,online,flocet,1
PittsburgBridgesTOrD,0.7599999904632568,0.21231913566589355,0.04187202453613281,200,online,flocet,1
PittsburgBridgesType,0.6538461446762085,0.2740950584411621,0.1408247947692871,200,online,flocet,1
Planning,0.6000000238418579,0.4748106002807617,0.09489178657531738,200,online,flocet,1
PlantMargin,0.39750000834465027,2.1518633365631104,1.0170910358428955,200,online,flocet,1
PlantShape,0.1574999988079071,1.8943252563476562,0.8558011054992676,200,online,flocet,1
PlantTexture,0.4350000023841858,2.1194496154785156,0.621635913848877,200,online,flocet,1
PostOperative,0.4545454680919647,0.19519972801208496,0.03723788261413574,200,online,flocet,1
PrimaryTumor,0.353658527135849,0.8276901245117188,0.12849998474121094,200,online,flocet,1
Ringnorm,0.8821621537208557,8.019201755523682,4.895254135131836,200,online,flocet,1
Seeds,0.942307710647583,0.4448714256286621,0.2792696952819824,200,online,flocet,1
Semeion,0.766331672668457,2.7606022357940674,1.8570237159729004,200,online,flocet,1
Soybean,0.7180851101875305,0.9916150569915771,1.21775484085083,200,online,flocet,1
Spambase,0.6808695793151855,5.3708062171936035,2.9933955669403076,200,online,flocet,1
Spect,0.4462365508079529,0.24664640426635742,0.4955332279205322,200,online,flocet,1
Spectf,0.5347593426704407,0.2545621395111084,0.7895252704620361,200,online,flocet,1
StatlogAustralianCredit,0.645348846912384,1.1165332794189453,0.49463963508605957,200,online,flocet,1
StatlogGermanCredit,0.6800000071525574,2.0893192291259766,0.8473091125488281,200,online,flocet,1
StatlogHeart,0.8059701323509216,0.35160183906555176,0.10442686080932617,200,online,flocet,1
StatlogImage,0.8630849123001099,2.7401785850524902,1.5994093418121338,200,online,flocet,1
StatlogLandsat,0.7764999866485596,8.53228211402893,5.752667188644409,200,online,flocet,1
StatlogShuttle,0.6902068853378296,54.39987397193909,33.790863275527954,200,online,flocet,1
StatlogVehicle,0.5450236797332764,1.219907283782959,0.33033204078674316,200,online,flocet,1
SteelPlates,0.5484536290168762,4.008131504058838,1.8474268913269043,200,online,flocet,1
SyntheticControl,0.7666666507720947,0.6152009963989258,0.23509979248046875,200,online,flocet,1
Teaching,0.5526315569877625,0.3958170413970947,0.19708991050720215,200,online,flocet,1
Thyroid,0.8830221891403198,5.711190700531006,11.632789134979248,200,online,flocet,1
TicTacToe,0.8828451633453369,1.40663743019104,0.37396931648254395,200,online,flocet,1
Titanic,0.5254545211791992,3.199362277984619,1.1235830783843994,200,online,flocet,1
Trains,0.5,0.02182912826538086,0.009045839309692383,200,online,flocet,1
Twonorm,0.9454054236412048,7.776845455169678,4.1635658740997314,200,online,flocet,1
VertebralColumn2Clases,0.7532467246055603,0.6439781188964844,0.4155285358428955,200,online,flocet,1
VertebralColumn3Clases,0.6233766078948975,0.28874778747558594,0.12017130851745605,200,online,flocet,1
WallFollowing,0.7991202473640442,6.098926067352295,3.2647244930267334,200,online,flocet,1
Waveform,0.7480000257492065,5.255310773849487,1.933321475982666,200,online,flocet,1
WaveformNoise,0.6751999855041504,5.597971677780151,3.0024185180664062,200,online,flocet,1
Wine,0.9545454382896423,0.2573833465576172,0.06884503364562988,200,online,flocet,1
WineQualityRed,0.5,3.9593918323516846,1.024275302886963,200,online,flocet,1
WineQualityWhite,0.43300652503967285,6.004079818725586,3.582923173904419,200,online,flocet,1
Yeast,0.4150943458080292,2.9051051139831543,1.5126709938049316,200,online,flocet,1
Zoo,0.9599999785423279,0.22105646133422852,0.13598871231079102,200,online,flocet,1
Abalone,0.5804597735404968,6.210399627685547,2.434694290161133,200,adjust,flocet,1
AcuteInflammation,1.0,0.22552728652954102,0.16316676139831543,200,adjust,flocet,1
AcuteNephritis,1.0,0.23969674110412598,0.11199378967285156,200,adjust,flocet,1
Adult,0.7892635464668274,61.85992074012756,47.136637926101685,200,adjust,flocet,1
Annealing,0.7200000286102295,1.6950523853302002,0.3487520217895508,200,adjust,flocet,1
Arrhythmia,0.5132743120193481,1.0056991577148438,0.17612695693969727,200,adjust,flocet,1
AudiologyStd,0.6800000071525574,0.6520352363586426,0.05127358436584473,200,adjust,flocet,1
BalanceScale,0.8782051205635071,1.1238174438476562,0.3809633255004883,200,adjust,flocet,1
Balloons,1.0,0.032019853591918945,0.013005495071411133,200,adjust,flocet,1
Bank,0.8389380574226379,4.937415361404419,3.045398473739624,200,adjust,flocet,1
Blood,0.7540106773376465,0.8202264308929443,0.48752856254577637,200,adjust,flocet,1
BreastCancer,0.7042253613471985,0.746830940246582,0.2931497097015381,200,adjust,flocet,1
BreastCancerWisc,0.9885714054107666,0.9886806011199951,0.2729766368865967,200,adjust,flocet,1
BreastCancerWiscDiag,0.9366196990013123,0.8964412212371826,0.2216329574584961,200,adjust,flocet,1
BreastCancerWiscProg,0.7755101919174194,0.5397286415100098,0.08034658432006836,200,adjust,flocet,1
BreastTissue,0.692307710647583,0.2980659008026123,0.14189505577087402,200,adjust,flocet,1
Car,0.8634259104728699,2.674201726913452,0.6716563701629639,200,adjust,flocet,1
Cardiotocography10Clases,0.6497175097465515,2.28200101852417,0.8229701519012451,200,adjust,flocet,1
Cardiotocography3Clases,0.9001883268356323,2.7313461303710938,1.506833553314209,200,adjust,flocet,1
ChessKrvk,0.39806100726127625,40.178749084472656,14.206159114837646,200,adjust,flocet,1
ChessKrvkp,0.8923654556274414,3.693955659866333,1.611842393875122,200,adjust,flocet,1
CongressionalVoting,0.5596330165863037,1.2475664615631104,0.5564718246459961,200,adjust,flocet,1
ConnBenchSonarMinesRocks,0.692307710647583,0.21639490127563477,0.0808875560760498,200,adjust,flocet,1
ConnBenchVowelDeterding,0.7121211886405945,1.8588273525238037,0.717698335647583,200,adjust,flocet,1
Connect4,0.7028835415840149,92.3613018989563,42.629369020462036,200,adjust,flocet,1
Contrac,0.4728260934352875,2.220135450363159,0.7907009124755859,200,adjust,flocet,1
CreditApproval,0.7965116500854492,1.1244993209838867,0.2699105739593506,200,adjust,flocet,1
CylinderBands,0.546875,0.7279856204986572,0.1984262466430664,200,adjust,flocet,1
Dermatology,0.9120879173278809,0.5603594779968262,0.141676664352417,200,adjust,flocet,1
Echocardiogram,0.8787878751754761,0.32110095024108887,0.17736148834228516,200,adjust,flocet,1
Ecoli,0.8214285969734192,0.4991488456726074,0.45008420944213867,200,adjust,flocet,1
EnergyY1,0.8645833134651184,0.7994039058685303,0.5127396583557129,200,adjust,flocet,1
EnergyY2,0.8645833134651184,1.2738761901855469,0.2983260154724121,200,adjust,flocet,1
Fertility,0.8399999737739563,0.24383211135864258,0.135345458984375,200,adjust,flocet,1
Flags,0.5,0.4823164939880371,0.259082555770874,200,adjust,flocet,1
Glass,0.24528302252292633,0.35084080696105957,0.08265995979309082,200,adjust,flocet,1
HabermanSurvival,0.6842105388641357,0.7331428527832031,0.11824965476989746,200,adjust,flocet,1
HayesRoth,0.75,0.47800517082214355,0.15160322189331055,200,adjust,flocet,1
HeartCleveland,0.43421053886413574,0.4471776485443115,0.11908459663391113,200,adjust,flocet,1
HeartHungarian,0.7397260069847107,0.69631028175354,0.11748909950256348,200,adjust,flocet,1
HeartSwitzerland,0.4516128897666931,0.38497018814086914,0.16806650161743164,200,adjust,flocet,1
HeartVa,0.20000000298023224,0.44037628173828125,0.2687699794769287,200,adjust,flocet,1
Hepatitis,0.8205128312110901,0.41347837448120117,0.10539698600769043,200,adjust,flocet,1
HillValley,0.5313531160354614,1.8875722885131836,2.1631104946136475,200,adjust,flocet,1
HorseColic,0.8088235259056091,0.9773740768432617,0.10665607452392578,200,adjust,flocet,1
IlpdIndianLiver,0.6575342416763306,1.0727543830871582,0.22713875770568848,200,adjust,flocet,1
ImageSegmentation,0.8142856955528259,0.5529501438140869,5.143839120864868,200,adjust,flocet,1
Ionosphere,0.9204545617103577,0.7683773040771484,0.13691949844360352,200,adjust,flocet,1
Iris,0.9459459185600281,0.3724801540374756,0.19893336296081543,200,adjust,flocet,1
LedDisplay,0.7839999794960022,1.1383368968963623,1.0930519104003906,200,adjust,flocet,1
Lenses,1.0,0.04382586479187012,0.010542154312133789,200,adjust,flocet,1
Letter,0.6010000109672546,27.929575204849243,15.159953594207764,200,adjust,flocet,1
Libras,0.5444444417953491,0.7414505481719971,0.14042329788208008,200,adjust,flocet,1
LowResSpect,0.7894737124443054,1.3747084140777588,0.415325403213501,200,adjust,flocet,1
LungCancer,0.375,0.05882906913757324,0.0443575382232666,200,adjust,flocet,1
Lymphography,0.8648648858070374,0.3875095844268799,0.19956398010253906,200,adjust,flocet,1
Magic,0.7467928528785706,25.851088047027588,14.631927013397217,200,adjust,flocet,1
Mammographic,0.7875000238418579,1.753047227859497,0.5643842220306396,200,adjust,flocet,1
Miniboone,0.762147843837738,196.5407383441925,99.16399002075195,200,adjust,flocet,1
MolecBiolPromoter,0.9230769276618958,0.24162936210632324,0.14105010032653809,200,adjust,flocet,1
MolecBiolSplice,0.595984935760498,4.849335432052612,3.4764509201049805,200,adjust,flocet,1
Monks1,0.7268518805503845,0.4247608184814453,1.5084543228149414,200,adjust,flocet,1
Monks2,0.8379629850387573,0.6036074161529541,1.4342246055603027,200,adjust,flocet,1
Monks3,0.8819444179534912,0.4316065311431885,1.6840522289276123,200,adjust,flocet,1
Mushroom,0.9881831407546997,9.032905340194702,5.251441478729248,200,adjust,flocet,1
Musk1,0.5630252361297607,0.5574700832366943,0.18570637702941895,200,adjust,flocet,1
Musk2,0.878714382648468,7.4043333530426025,4.768104553222656,200,adjust,flocet,1
Nursery,0.9132716059684753,15.232066869735718,7.751751184463501,200,adjust,flocet,1
OocytesMerlucciusNucleus4d,0.6196078658103943,1.9672987461090088,0.39692211151123047,200,adjust,flocet,1
OocytesMerlucciusStates2f,0.8823529481887817,1.421360731124878,0.929297685623169,200,adjust,flocet,1
OocytesTrisopterusNucleus2f,0.6052631735801697,1.4131855964660645,0.7534074783325195,200,adjust,flocet,1
OocytesTrisopterusStates5b,0.7894737124443054,1.7925221920013428,0.7929196357727051,200,adjust,flocet,1
Optical,0.8636616468429565,5.916650295257568,4.059865236282349,200,adjust,flocet,1
Ozone,0.9574132561683655,3.9746108055114746,1.2414286136627197,200,adjust,flocet,1
PageBlocks,0.9261695742607117,8.492923021316528,3.375549077987671,200,adjust,flocet,1
Parkinsons,0.8367347121238708,0.49828338623046875,0.26250648498535156,200,adjust,flocet,1
Pendigits,0.8970840573310852,12.770903825759888,7.566759824752808,200,adjust,flocet,1
Pima,0.7395833134651184,1.7799718379974365,0.2959134578704834,200,adjust,flocet,1
PittsburgBridgesMaterial,0.9615384340286255,0.26917028427124023,0.13955378532409668,200,adjust,flocet,1
PittsburgBridgesRelL,0.5769230723381042,0.21313905715942383,0.13998150825500488,200,adjust,flocet,1
PittsburgBridgesSpan,0.739130437374115,0.25051164627075195,0.12450528144836426,200,adjust,flocet,1
PittsburgBridgesTOrD,0.8399999737739563,0.24315142631530762,0.12259125709533691,200,adjust,flocet,1
PittsburgBridgesType,0.42307692766189575,0.2957017421722412,0.14253926277160645,200,adjust,flocet,1
Planning,0.6000000238418579,0.5106651782989502,0.08310270309448242,200,adjust,flocet,1
PlantMargin,0.4449999928474426,2.643563985824585,1.2608363628387451,200,adjust,flocet,1
PlantShape,0.23000000417232513,2.14850115776062,1.1342966556549072,200,adjust,flocet,1
PlantTexture,0.48249998688697815,1.955573320388794,0.6250231266021729,200,adjust,flocet,1
PostOperative,0.4545454680919647,0.23706912994384766,0.11861157417297363,200,adjust,flocet,1
PrimaryTumor,0.40243902802467346,0.8473062515258789,0.44258856773376465,200,adjust,flocet,1
Ringnorm,0.9221621751785278,10.324037075042725,4.403483152389526,200,adjust,flocet,1
Seeds,0.9230769276618958,0.4355320930480957,0.0988612174987793,200,adjust,flocet,1
Semeion,0.7763819098472595,1.8675341606140137,1.1282339096069336,200,adjust,flocet,1
Soybean,0.813829779624939,0.7856669425964355,0.8581709861755371,200,adjust,flocet,1
Spambase,0.7417391538619995,6.1271812915802,2.0398101806640625,200,adjust,flocet,1
Spect,0.6559139490127563,0.2824676036834717,0.547008752822876,200,adjust,flocet,1
Spectf,0.8288770318031311,0.3000664710998535,0.6490752696990967,200,adjust,flocet,1
StatlogAustralianCredit,0.5581395626068115,1.3444314002990723,0.5703003406524658,200,adjust,flocet,1
StatlogGermanCredit,0.6919999718666077,1.5830044746398926,0.6137604713439941,200,adjust,flocet,1
StatlogHeart,0.7910447716712952,0.6982166767120361,0.2225053310394287,200,adjust,flocet,1
StatlogImage,0.8977469801902771,2.562232255935669,1.2644319534301758,200,adjust,flocet,1
StatlogLandsat,0.7950000166893005,8.859222650527954,4.494233846664429,200,adjust,flocet,1
StatlogShuttle,0.5075861811637878,77.96723365783691,48.229209899902344,200,adjust,flocet,1
StatlogVehicle,0.5687204003334045,1.9419116973876953,0.5069189071655273,200,adjust,flocet,1
SteelPlates,0.5690721869468689,4.611212491989136,0.9467606544494629,200,adjust,flocet,1
SyntheticControl,0.846666693687439,1.1040973663330078,0.23441743850708008,200,adjust,flocet,1
Teaching,0.5263158082962036,0.4447743892669678,0.16817140579223633,200,adjust,flocet,1
Thyroid,0.8833138942718506,7.6310975551605225,10.05002498626709,200,adjust,flocet,1
TicTacToe,0.9246861934661865,1.3713586330413818,0.3725605010986328,200,adjust,flocet,1
Titanic,0.41818180680274963,3.2374441623687744,1.546980381011963,200,adjust,flocet,1
Trains,0.5,0.023485660552978516,0.009267807006835938,200,adjust,flocet,1
Twonorm,0.9454054236412048,9.992403507232666,5.027230262756348,200,adjust,flocet,1
VertebralColumn2Clases,0.7532467246055603,0.5309953689575195,0.33492541313171387,200,adjust,flocet,1
VertebralColumn3Clases,0.44155845046043396,0.6208252906799316,0.2868154048919678,200,adjust,flocet,1
WallFollowing,0.8181818127632141,8.053465127944946,3.3956265449523926,200,adjust,flocet,1
Waveform,0.7983999848365784,7.098500728607178,2.9055027961730957,200,adjust,flocet,1
WaveformNoise,0.7519999742507935,8.022447109222412,2.6187195777893066,200,adjust,flocet,1
Wine,0.9090909361839294,0.3628265857696533,0.07100749015808105,200,adjust,flocet,1
WineQualityRed,0.5274999737739563,2.9346954822540283,0.6215741634368896,200,adjust,flocet,1
WineQualityWhite,0.40032678842544556,8.59588360786438,2.9419326782226562,200,adjust,flocet,1
Yeast,0.5363881587982178,3.563626766204834,1.3556444644927979,200,adjust,flocet,1
Zoo,0.8399999737739563,0.23909831047058105,0.13530755043029785,200,adjust,flocet,1
Abalone,0.4568965435028076,5.103487968444824,2.4313008785247803,100,adapt,flocet,1
AcuteInflammation,1.0,0.21698212623596191,0.1617755889892578,100,adapt,flocet,1
AcuteNephritis,1.0,0.23102951049804688,0.11958527565002441,100,adapt,flocet,1
Adult,0.7145138382911682,51.35988521575928,44.11782693862915,100,adapt,flocet,1
Annealing,0.7799999713897705,1.5404391288757324,0.15552115440368652,100,adapt,flocet,1
Arrhythmia,0.4247787594795227,0.9767701625823975,0.45279860496520996,100,adapt,flocet,1
AudiologyStd,0.4399999976158142,0.38244104385375977,0.1399543285369873,100,adapt,flocet,1
BalanceScale,0.7756410241127014,1.073134422302246,0.5060610771179199,100,adapt,flocet,1
Balloons,0.75,0.023179292678833008,0.012006998062133789,100,adapt,flocet,1
Bank,0.886725664138794,5.974175930023193,2.43711256980896,100,adapt,flocet,1
Blood,0.7486631274223328,0.8932626247406006,0.7700505256652832,100,adapt,flocet,1
BreastCancer,0.7183098793029785,0.6196272373199463,0.11624693870544434,100,adapt,flocet,1
BreastCancerWisc,0.9599999785423279,1.062544345855713,0.6235227584838867,100,adapt,flocet,1
BreastCancerWiscDiag,0.922535240650177,0.6138925552368164,0.5974135398864746,100,adapt,flocet,1
BreastCancerWiscProg,0.795918345451355,0.4100151062011719,0.2633206844329834,100,adapt,flocet,1
BreastTissue,0.42307692766189575,0.23088502883911133,0.04370236396789551,100,adapt,flocet,1
Car,0.875,2.05895733833313,1.4951245784759521,100,adapt,flocet,1
Cardiotocography10Clases,0.508474588394165,2.131242036819458,1.7651896476745605,100,adapt,flocet,1
Cardiotocography3Clases,0.839924693107605,2.78251051902771,1.1559960842132568,100,adapt,flocet,1
ChessKrvk,0.26489877700805664,31.93788743019104,15.765600442886353,100,adapt,flocet,1
ChessKrvkp,0.831038773059845,3.9519245624542236,1.6408648490905762,100,adapt,flocet,1
CongressionalVoting,0.5321100950241089,0.98368239402771,0.1758897304534912,100,adapt,flocet,1
ConnBenchSonarMinesRocks,0.6346153616905212,0.4616730213165283,0.277724027633667,100,adapt,flocet,1
ConnBenchVowelDeterding,0.5043290257453918,1.2208991050720215,0.909191370010376,100,adapt,flocet,1
Connect4,0.7018177509307861,75.5580427646637,40.942193269729614,100,adapt,flocet,1
Contrac,0.4320652186870575,1.6556754112243652,0.5870616436004639,100,adapt,flocet,1
CreditApproval,0.8139534592628479,1.1229617595672607,0.6841638088226318,100,adapt,flocet,1
CylinderBands,0.578125,0.5183465480804443,0.2055513858795166,100,adapt,flocet,1
Dermatology,0.8461538553237915,0.562645435333252,0.1771526336669922,100,adapt,flocet,1
Echocardiogram,0.7878788113594055,0.250560998916626,0.1765143871307373,100,adapt,flocet,1
Ecoli,0.8095238208770752,0.5180280208587646,0.4529082775115967,100,adapt,flocet,1
EnergyY1,0.8541666865348816,1.034735918045044,0.5814971923828125,100,adapt,flocet,1
EnergyY2,0.75,1.6588187217712402,0.30945682525634766,100,adapt,flocet,1
Fertility,0.5600000023841858,0.20163321495056152,0.1351773738861084,100,adapt,flocet,1
Flags,0.4791666567325592,0.4298534393310547,0.25894927978515625,100,adapt,flocet,1
Glass,0.30188679695129395,0.4902803897857666,0.17415404319763184,100,adapt,flocet,1
HabermanSurvival,0.5131579041481018,0.672839879989624,0.3687453269958496,100,adapt,flocet,1
HayesRoth,0.7142857313156128,0.3898489475250244,0.15090250968933105,100,adapt,flocet,1
HeartCleveland,0.5921052694320679,0.4427351951599121,0.12201786041259766,100,adapt,flocet,1
HeartHungarian,0.7397260069847107,0.6199986934661865,0.22115850448608398,100,adapt,flocet,1
HeartSwitzerland,0.25806450843811035,0.28594017028808594,0.16742825508117676,100,adapt,flocet,1
HeartVa,0.20000000298023224,0.4019913673400879,0.07960343360900879,100,adapt,flocet,1
Hepatitis,0.8461538553237915,0.34960412979125977,0.2087411880493164,100,adapt,flocet,1
HillValley,0.5181518197059631,1.491804838180542,1.6511051654815674,100,adapt,flocet,1
HorseColic,0.6470588445663452,0.8327898979187012,0.34203457832336426,100,adapt,flocet,1
IlpdIndianLiver,0.568493127822876,1.0484986305236816,0.22537446022033691,100,adapt,flocet,1
ImageSegmentation,0.6376190185546875,0.607475757598877,7.677240371704102,100,adapt,flocet,1
Ionosphere,0.7727272510528564,0.671154260635376,0.4718441963195801,100,adapt,flocet,1
Iris,0.9729729890823364,0.24165582656860352,0.19861173629760742,100,adapt,flocet,1
LedDisplay,0.527999997138977,1.9110524654388428,0.38637375831604004,100,adapt,flocet,1
Lenses,0.8333333134651184,0.0412447452545166,0.02846837043762207,100,adapt,flocet,1
Letter,0.4323999881744385,25.249433279037476,17.15684151649475,100,adapt,flocet,1
Libras,0.3444444537162781,0.6413824558258057,0.22570085525512695,100,adapt,flocet,1
LowResSpect,0.6766917109489441,0.8574943542480469,0.6464378833770752,100,adapt,flocet,1
LungCancer,0.25,0.04543709754943848,0.023610830307006836,100,adapt,flocet,1
Lymphography,0.6486486196517944,0.16046929359436035,0.07714009284973145,100,adapt,flocet,1
Magic,0.7808622717857361,26.148096323013306,13.005119562149048,100,adapt,flocet,1
Mammographic,0.75,1.398061990737915,0.6345252990722656,100,adapt,flocet,1
Miniboone,0.7283798456192017,164.30335807800293,103.22673201560974,100,adapt,flocet,1
MolecBiolPromoter,0.7692307829856873,0.20077013969421387,0.14012813568115234,100,adapt,flocet,1
MolecBiolSplice,0.5307402610778809,4.029455184936523,2.229464530944824,100,adapt,flocet,1
Monks1,0.6388888955116272,0.32696056365966797,0.9223194122314453,100,adapt,flocet,1
Monks2,0.875,0.33915019035339355,1.5512313842773438,100,adapt,flocet,1
Monks3,0.7754629850387573,0.35634732246398926,0.6878666877746582,100,adapt,flocet,1
Mushroom,0.9773510694503784,9.255219459533691,6.9759416580200195,100,adapt,flocet,1
Musk1,0.605042040348053,0.9324328899383545,0.3557133674621582,100,adapt,flocet,1
Musk2,0.8611279726028442,6.906322002410889,6.294832706451416,100,adapt,flocet,1
Nursery,0.8567901253700256,19.497875690460205,7.3949480056762695,100,adapt,flocet,1
OocytesMerlucciusNucleus4d,0.6078431606292725,1.9474263191223145,0.9817605018615723,100,adapt,flocet,1
OocytesMerlucciusStates2f,0.8274509906768799,1.6574795246124268,1.0865304470062256,100,adapt,flocet,1
OocytesTrisopterusNucleus2f,0.5877193212509155,1.1536295413970947,0.9968624114990234,100,adapt,flocet,1
OocytesTrisopterusStates5b,0.7719298005104065,1.329418420791626,0.3652522563934326,100,adapt,flocet,1
Optical,0.816360592842102,8.085907697677612,6.2489213943481445,100,adapt,flocet,1
Ozone,0.9716088175773621,2.730065107345581,2.0339369773864746,100,adapt,flocet,1
PageBlocks,0.9144737124443054,6.25081992149353,4.575696229934692,100,adapt,flocet,1
Parkinsons,0.8367347121238708,0.1693708896636963,0.21227192878723145,100,adapt,flocet,1
Pendigits,0.8456260561943054,13.472353458404541,6.517285108566284,100,adapt,flocet,1
Pima,0.6666666865348816,1.5055582523345947,0.687213659286499,100,adapt,flocet,1
PittsburgBridgesMaterial,0.9230769276618958,0.23200011253356934,0.13137316703796387,100,adapt,flocet,1
PittsburgBridgesRelL,0.6538461446762085,0.2025601863861084,0.14132475852966309,100,adapt,flocet,1
PittsburgBridgesSpan,0.43478259444236755,0.20776867866516113,0.12400150299072266,100,adapt,flocet,1
PittsburgBridgesTOrD,0.6000000238418579,0.19811391830444336,0.08937358856201172,100,adapt,flocet,1
PittsburgBridgesType,0.38461539149284363,0.21988844871520996,0.1423790454864502,100,adapt,flocet,1
Planning,0.3333333432674408,0.3954277038574219,0.19495749473571777,100,adapt,flocet,1
PlantMargin,0.2475000023841858,2.0525856018066406,0.8446846008300781,100,adapt,flocet,1
PlantShape,0.05000000074505806,2.7908284664154053,1.8150238990783691,100,adapt,flocet,1
PlantTexture,0.19499999284744263,1.5143311023712158,1.6604206562042236,100,adapt,flocet,1
PostOperative,0.7272727489471436,0.10768795013427734,0.11683320999145508,100,adapt,flocet,1
PrimaryTumor,0.353658527135849,0.7806096076965332,0.20241498947143555,100,adapt,flocet,1
Ringnorm,0.931891918182373,9.812256813049316,5.497964382171631,100,adapt,flocet,1
Seeds,0.9230769276618958,0.414201021194458,0.22175002098083496,100,adapt,flocet,1
Semeion,0.6582914590835571,1.6937799453735352,0.6429617404937744,100,adapt,flocet,1
Soybean,0.7367021441459656,0.6975288391113281,1.5721454620361328,100,adapt,flocet,1
Spambase,0.7747825980186462,5.3760011196136475,2.7131333351135254,100,adapt,flocet,1
Spect,0.6935483813285828,0.2356405258178711,0.735461950302124,100,adapt,flocet,1
Spectf,0.7272727489471436,0.2132124900817871,0.6590495109558105,100,adapt,flocet,1
StatlogAustralianCredit,0.5581395626068115,0.973801851272583,0.8534176349639893,100,adapt,flocet,1
StatlogGermanCredit,0.6800000071525574,0.7635037899017334,0.5537676811218262,100,adapt,flocet,1
StatlogHeart,0.8358209133148193,0.6029336452484131,0.13495945930480957,100,adapt,flocet,1
StatlogImage,0.8734835386276245,3.6012091636657715,1.8866887092590332,100,adapt,flocet,1
StatlogLandsat,0.7935000061988831,7.026085376739502,6.255028486251831,100,adapt,flocet,1
StatlogShuttle,0.7886896729469299,76.79287958145142,45.985997676849365,100,adapt,flocet,1
StatlogVehicle,0.5402843356132507,1.746443748474121,0.6877303123474121,100,adapt,flocet,1
SteelPlates,0.5835051536560059,2.637357234954834,1.2444195747375488,100,adapt,flocet,1
SyntheticControl,0.7333333492279053,0.8345115184783936,0.5109717845916748,100,adapt,flocet,1
Teaching,0.42105263471603394,0.24992775917053223,0.08064508438110352,100,adapt,flocet,1
Thyroid,0.9396149516105652,6.522592544555664,9.378047704696655,100,adapt,flocet,1
TicTacToe,0.874476969242096,1.5869097709655762,0.6160528659820557,100,adapt,flocet,1
Titanic,0.5090909004211426,2.8327815532684326,1.748004674911499,100,adapt,flocet,1
Trains,0.5,0.011352062225341797,0.0045239925384521484,100,adapt,flocet,1
Twonorm,0.9178378582000732,8.923196077346802,4.81387734413147,100,adapt,flocet,1
VertebralColumn2Clases,0.8051947951316833,0.3236269950866699,0.12327218055725098,100,adapt,flocet,1
VertebralColumn3Clases,0.4935064911842346,0.5958504676818848,0.1792910099029541,100,adapt,flocet,1
WallFollowing,0.7280058860778809,8.975842237472534,3.1680893898010254,100,adapt,flocet,1
Waveform,0.6384000182151794,5.600905656814575,2.9582533836364746,100,adapt,flocet,1
WaveformNoise,0.6128000020980835,8.070992946624756,2.5650277137756348,100,adapt,flocet,1
Wine,0.9545454382896423,0.3757157325744629,0.09561276435852051,100,adapt,flocet,1
WineQualityRed,0.5575000047683716,1.7595291137695312,0.9189116954803467,100,adapt,flocet,1
WineQualityWhite,0.3741829991340637,5.175321102142334,3.938506841659546,100,adapt,flocet,1
Yeast,0.48787063360214233,2.324019193649292,1.0029141902923584,100,adapt,flocet,1
Zoo,0.8799999952316284,0.2055225372314453,0.13482189178466797,100,adapt,flocet,1
Abalone,0.4712643623352051,7.740971803665161,2.6386663913726807,100,online,flocet,1
AcuteInflammation,1.0,0.2296133041381836,0.15912866592407227,100,online,flocet,1
AcuteNephritis,1.0,0.12594866752624512,0.05072832107543945,100,online,flocet,1
Adult,0.7363184094429016,61.45359206199646,49.41696524620056,100,online,flocet,1
Annealing,0.3199999928474426,1.5468723773956299,0.5320751667022705,100,online,flocet,1
Arrhythmia,0.23893804848194122,0.49504876136779785,0.17557859420776367,100,online,flocet,1
AudiologyStd,0.5600000023841858,0.4516408443450928,0.039798736572265625,100,online,flocet,1
BalanceScale,0.8461538553237915,1.059619426727295,0.24290156364440918,100,online,flocet,1
Balloons,0.75,0.029676198959350586,0.01876068115234375,100,online,flocet,1
Bank,0.8460177183151245,4.800874471664429,4.112567663192749,100,online,flocet,1
Blood,0.6042780876159668,0.9295051097869873,0.3000295162200928,100,online,flocet,1
BreastCancer,0.7042253613471985,0.6732409000396729,0.37973475456237793,100,online,flocet,1
BreastCancerWisc,0.9599999785423279,1.0912868976593018,0.8046014308929443,100,online,flocet,1
BreastCancerWiscDiag,0.908450722694397,1.100851058959961,0.3305015563964844,100,online,flocet,1
BreastCancerWiscProg,0.7142857313156128,0.4760768413543701,0.26168084144592285,100,online,flocet,1
BreastTissue,0.7692307829856873,0.12656426429748535,0.07627344131469727,100,online,flocet,1
Car,0.8726851940155029,2.5059385299682617,1.7004499435424805,100,online,flocet,1
Cardiotocography10Clases,0.6534839868545532,2.7179760932922363,0.8231821060180664,100,online,flocet,1
Cardiotocography3Clases,0.8681732416152954,3.807983160018921,2.1051971912384033,100,online,flocet,1
ChessKrvk,0.29284289479255676,43.27655601501465,16.864920616149902,100,online,flocet,1
ChessKrvkp,0.8285356760025024,3.7580840587615967,1.4692432880401611,100,online,flocet,1
CongressionalVoting,0.5688073635101318,1.1135985851287842,0.4797203540802002,100,online,flocet,1
ConnBenchSonarMinesRocks,0.7307692170143127,0.47681212425231934,0.2798275947570801,100,online,flocet,1
ConnBenchVowelDeterding,0.6017315983772278,0.8497827053070068,1.5854299068450928,100,online,flocet,1
Connect4,0.6715021729469299,107.4579439163208,49.29488801956177,100,online,flocet,1
Contrac,0.40760868787765503,3.490859270095825,1.7268872261047363,100,online,flocet,1
CreditApproval,0.7616279125213623,1.1462953090667725,0.7336819171905518,100,online,flocet,1
CylinderBands,0.5390625,1.0870769023895264,0.20029211044311523,100,online,flocet,1
Dermatology,0.901098906993866,0.7928192615509033,0.3805701732635498,100,online,flocet,1
Echocardiogram,0.8787878751754761,0.3030884265899658,0.1321239471435547,100,online,flocet,1
Ecoli,0.8333333134651184,0.5096409320831299,0.2764589786529541,100,online,flocet,1
EnergyY1,0.8333333134651184,1.4189121723175049,0.501265287399292,100,online,flocet,1
EnergyY2,0.8177083134651184,1.425572395324707,0.9592180252075195,100,online,flocet,1
Fertility,0.6800000071525574,0.19988679885864258,0.13660168647766113,100,online,flocet,1
Flags,0.3958333432674408,0.49212193489074707,0.1682584285736084,100,online,flocet,1
Glass,0.15094339847564697,0.42725253105163574,0.28240227699279785,100,online,flocet,1
HabermanSurvival,0.5921052694320679,0.4381070137023926,0.3247699737548828,100,online,flocet,1
HayesRoth,0.75,0.42578816413879395,0.06492376327514648,100,online,flocet,1
HeartCleveland,0.40789473056793213,0.6156549453735352,0.3561246395111084,100,online,flocet,1
HeartHungarian,0.6301369667053223,0.6073741912841797,0.3670642375946045,100,online,flocet,1
HeartSwitzerland,0.3870967626571655,0.17749834060668945,0.12775158882141113,100,online,flocet,1
HeartVa,0.3400000035762787,0.5728464126586914,0.1370837688446045,100,online,flocet,1
Hepatitis,0.692307710647583,0.22313523292541504,0.20952415466308594,100,online,flocet,1
HillValley,0.5016501545906067,1.4675853252410889,2.126547336578369,100,online,flocet,1
HorseColic,0.7352941036224365,0.8828048706054688,0.10645532608032227,100,online,flocet,1
IlpdIndianLiver,0.7260273694992065,0.8765377998352051,0.5841274261474609,100,online,flocet,1
ImageSegmentation,0.8061904907226562,0.45086073875427246,6.1499505043029785,100,online,flocet,1
Ionosphere,0.8295454382896423,0.7570211887359619,0.20048141479492188,100,online,flocet,1
Iris,0.9729729890823364,0.33458948135375977,0.1989283561706543,100,online,flocet,1
LedDisplay,0.6959999799728394,1.8057246208190918,0.8379077911376953,100,online,flocet,1
Lenses,0.8333333134651184,0.04927420616149902,0.022939205169677734,100,online,flocet,1
Letter,0.5515999794006348,30.538644790649414,13.35554575920105,100,online,flocet,1
Libras,0.46666666865348816,0.49753403663635254,0.1402430534362793,100,online,flocet,1
LowResSpect,0.7894737124443054,1.0525739192962646,0.5948169231414795,100,online,flocet,1
LungCancer,0.125,0.04881787300109863,0.015657424926757812,100,online,flocet,1
Lymphography,0.837837815284729,0.29317331314086914,0.1995561122894287,100,online,flocet,1
Magic,0.5543638467788696,23.80647301673889,15.83567762374878,100,online,flocet,1
Mammographic,0.7875000238418579,1.921922206878662,0.9066274166107178,100,online,flocet,1
Miniboone,0.49012795090675354,164.18283367156982,102.48383116722107,100,online,flocet,1
MolecBiolPromoter,0.807692289352417,0.18824553489685059,0.04391646385192871,100,online,flocet,1
MolecBiolSplice,0.5269761681556702,3.8245437145233154,3.0444772243499756,100,online,flocet,1
Monks1,0.5625,0.3176851272583008,2.13364839553833,100,online,flocet,1
Monks2,0.8888888955116272,0.5193018913269043,1.7395644187927246,100,online,flocet,1
Monks3,0.8587962985038757,0.299274206161499,1.7262184619903564,100,online,flocet,1
Mushroom,0.9867060780525208,13.378307580947876,7.787811279296875,100,online,flocet,1
Musk1,0.5882353186607361,1.0733528137207031,0.6421387195587158,100,online,flocet,1
Musk2,0.8714372515678406,9.21255087852478,4.828152179718018,100,online,flocet,1
Nursery,0.874382734298706,17.22670078277588,10.973346471786499,100,online,flocet,1
OocytesMerlucciusNucleus4d,0.5764706134796143,1.5531179904937744,0.5348014831542969,100,online,flocet,1
OocytesMerlucciusStates2f,0.8627451062202454,1.3548896312713623,0.40660762786865234,100,online,flocet,1
OocytesTrisopterusNucleus2f,0.6491228342056274,1.4749267101287842,0.8514416217803955,100,online,flocet,1
OocytesTrisopterusStates5b,0.780701756477356,1.2777414321899414,0.3510704040527344,100,online,flocet,1
Optical,0.7941012978553772,6.2372589111328125,4.099949836730957,100,online,flocet,1
Ozone,0.9542586803436279,2.878479480743408,1.3997905254364014,100,online,flocet,1
PageBlocks,0.9137426614761353,5.204221725463867,3.4152321815490723,100,online,flocet,1
Parkinsons,0.8367347121238708,0.36332035064697266,0.26224613189697266,100,online,flocet,1
Pendigits,0.8547741770744324,9.466675758361816,9.28065037727356,100,online,flocet,1
Pima,0.6822916865348816,1.2604894638061523,0.6113526821136475,100,online,flocet,1
PittsburgBridgesMaterial,0.8846153616905212,0.24248194694519043,0.139892578125,100,online,flocet,1
PittsburgBridgesRelL,0.42307692766189575,0.12630462646484375,0.04119873046875,100,online,flocet,1
PittsburgBridgesSpan,0.6521739363670349,0.2195136547088623,0.12464475631713867,100,online,flocet,1
PittsburgBridgesTOrD,0.9200000166893005,0.21615099906921387,0.13509488105773926,100,online,flocet,1
PittsburgBridgesType,0.38461539149284363,0.27913570404052734,0.14139127731323242,100,online,flocet,1
Planning,0.5111111402511597,0.46859264373779297,0.2420358657836914,100,online,flocet,1
PlantMargin,0.33500000834465027,1.469332218170166,0.6215569972991943,100,online,flocet,1
PlantShape,0.13750000298023224,2.551570177078247,0.9489891529083252,100,online,flocet,1
PlantTexture,0.32249999046325684,4.015467643737793,1.5779075622558594,100,online,flocet,1
PostOperative,0.5,0.19850373268127441,0.11914324760437012,100,online,flocet,1
PrimaryTumor,0.31707316637039185,0.5917673110961914,0.4389972686767578,100,online,flocet,1
Ringnorm,0.9021621346473694,10.924720764160156,4.434477090835571,100,online,flocet,1
Seeds,0.8461538553237915,0.4560098648071289,0.27995777130126953,100,online,flocet,1
Semeion,0.6457286477088928,1.7982776165008545,1.1086390018463135,100,online,flocet,1
Soybean,0.707446813583374,0.9280712604522705,1.408583402633667,100,online,flocet,1
Spambase,0.6034782528877258,8.52738618850708,2.421666383743286,100,online,flocet,1
Spect,0.6182795763015747,0.2536916732788086,0.3809244632720947,100,online,flocet,1
Spectf,0.7165775299072266,0.23773932456970215,0.736264705657959,100,online,flocet,1
StatlogAustralianCredit,0.5523256063461304,1.254770040512085,0.26686906814575195,100,online,flocet,1
StatlogGermanCredit,0.6200000047683716,1.3513820171356201,1.044541358947754,100,online,flocet,1
StatlogHeart,0.8208954930305481,0.6267588138580322,0.2215557098388672,100,online,flocet,1
StatlogImage,0.8492200970649719,2.8494365215301514,1.8490862846374512,100,online,flocet,1
StatlogLandsat,0.7670000195503235,6.245965480804443,4.143393278121948,100,online,flocet,1
StatlogShuttle,0.6837931275367737,57.52280116081238,36.66080451011658,100,online,flocet,1
StatlogVehicle,0.5450236797332764,1.349111557006836,0.8855388164520264,100,online,flocet,1
SteelPlates,0.5072165131568909,2.9506168365478516,1.1728649139404297,100,online,flocet,1
SyntheticControl,0.7333333492279053,0.9958326816558838,0.7627904415130615,100,online,flocet,1
Teaching,0.3947368562221527,0.253359317779541,0.06141805648803711,100,online,flocet,1
Thyroid,0.9148191213607788,6.070223093032837,7.787158727645874,100,online,flocet,1
TicTacToe,0.8326359987258911,1.3704423904418945,0.6558794975280762,100,online,flocet,1
Titanic,0.5309090614318848,2.6044623851776123,1.373795986175537,100,online,flocet,1
Trains,0.5,0.021147489547729492,0.009186983108520508,100,online,flocet,1
Twonorm,0.9172973036766052,8.020553350448608,3.8478994369506836,100,online,flocet,1
VertebralColumn2Clases,0.7402597665786743,0.7122836112976074,0.2877495288848877,100,online,flocet,1
VertebralColumn3Clases,0.5064935088157654,0.7409977912902832,0.25797271728515625,100,online,flocet,1
WallFollowing,0.7324047088623047,7.725887775421143,2.7461600303649902,100,online,flocet,1
Waveform,0.656000018119812,5.337896823883057,5.287691354751587,100,online,flocet,1
WaveformNoise,0.5600000023841858,6.511112928390503,2.682112216949463,100,online,flocet,1
Wine,0.8181818127632141,0.324857234954834,0.21332883834838867,100,online,flocet,1
WineQualityRed,0.5450000166893005,2.4082705974578857,0.8715956211090088,100,online,flocet,1
WineQualityWhite,0.37826797366142273,9.384730815887451,2.531301498413086,100,online,flocet,1
Yeast,0.42587602138519287,3.0288665294647217,0.8916177749633789,100,online,flocet,1
Zoo,0.9599999785423279,0.20078754425048828,0.13556146621704102,100,online,flocet,1
Abalone,0.5565134286880493,5.635098218917847,2.162362813949585,100,adjust,flocet,1
AcuteInflammation,1.0,0.26074910163879395,0.1622941493988037,100,adjust,flocet,1
AcuteNephritis,1.0,0.2737751007080078,0.04987525939941406,100,adjust,flocet,1
Adult,0.7901848554611206,46.64275026321411,29.70306086540222,100,adjust,flocet,1
Annealing,0.5699999928474426,2.2249515056610107,0.15515494346618652,100,adjust,flocet,1
Arrhythmia,0.3008849620819092,1.325498342514038,0.33182549476623535,100,adjust,flocet,1
AudiologyStd,0.6000000238418579,0.6687088012695312,0.13628721237182617,100,adjust,flocet,1
BalanceScale,0.8910256624221802,1.2249298095703125,0.24824976921081543,100,adjust,flocet,1
Balloons,0.5,0.027623891830444336,0.0159146785736084,100,adjust,flocet,1
Bank,0.8424778580665588,5.852389097213745,1.7948157787322998,100,adjust,flocet,1
Blood,0.7058823704719543,1.8838701248168945,0.3003382682800293,100,adjust,flocet,1
BreastCancer,0.6760563254356384,0.7797129154205322,0.38364672660827637,100,adjust,flocet,1
BreastCancerWisc,0.954285740852356,1.5364928245544434,0.2806541919708252,100,adjust,flocet,1
BreastCancerWiscDiag,0.9436619877815247,0.9026882648468018,0.22021222114562988,100,adjust,flocet,1
BreastCancerWiscProg,0.8367347121238708,0.49300384521484375,0.08069133758544922,100,adjust,flocet,1
BreastTissue,0.692307710647583,0.2994825839996338,0.14080572128295898,100,adjust,flocet,1
Car,0.8935185074806213,2.3314871788024902,1.3863804340362549,100,adjust,flocet,1
Cardiotocography10Clases,0.6120527386665344,3.0061705112457275,0.8243825435638428,100,adjust,flocet,1
Cardiotocography3Clases,0.8681732416152954,2.9507670402526855,1.4582748413085938,100,adjust,flocet,1
ChessKrvk,0.3664100468158722,45.01512408256531,17.98238444328308,100,adjust,flocet,1
ChessKrvkp,0.8623279333114624,4.317127227783203,3.153395652770996,100,adjust,flocet,1
CongressionalVoting,0.6238532066345215,0.9004678726196289,0.400820255279541,100,adjust,flocet,1
ConnBenchSonarMinesRocks,0.7307692170143127,0.5577566623687744,0.09471940994262695,100,adjust,flocet,1
ConnBenchVowelDeterding,0.5173160433769226,1.1771745681762695,0.7810244560241699,100,adjust,flocet,1
Connect4,0.6643377542495728,101.23064661026001,46.860159397125244,100,adjust,flocet,1
Contrac,0.48641303181648254,1.8547968864440918,1.026273250579834,100,adjust,flocet,1
CreditApproval,0.8430232405662537,0.731853723526001,0.5296988487243652,100,adjust,flocet,1
CylinderBands,0.640625,0.975327730178833,0.20543551445007324,100,adjust,flocet,1
Dermatology,0.9120879173278809,0.6862707138061523,0.14625310897827148,100,adjust,flocet,1
Echocardiogram,0.9090909361839294,0.34555768966674805,0.1787724494934082,100,adjust,flocet,1
Ecoli,0.7976190447807312,0.5305895805358887,0.4490985870361328,100,adjust,flocet,1
EnergyY1,0.8489583134651184,1.1328065395355225,0.3521997928619385,100,adjust,flocet,1
EnergyY2,0.8645833134651184,1.071894645690918,0.721513032913208,100,adjust,flocet,1
Fertility,0.6800000071525574,0.16466307640075684,0.09498333930969238,100,adjust,flocet,1
Flags,0.4375,0.5891859531402588,0.08429479598999023,100,adjust,flocet,1
Glass,0.37735849618911743,0.578547477722168,0.282501220703125,100,adjust,flocet,1
HabermanSurvival,0.6315789222717285,0.7962551116943359,0.29032230377197266,100,adjust,flocet,1
HayesRoth,0.75,0.4717550277709961,0.1503925323486328,100,adjust,flocet,1
HeartCleveland,0.5789473652839661,0.4687643051147461,0.11973929405212402,100,adjust,flocet,1
HeartHungarian,0.767123281955719,0.740882158279419,0.3918178081512451,100,adjust,flocet,1
HeartSwitzerland,0.22580644488334656,0.3667476177215576,0.1669752597808838,100,adjust,flocet,1
HeartVa,0.23999999463558197,0.2863807678222656,0.07836532592773438,100,adjust,flocet,1
Hepatitis,0.7692307829856873,0.4047529697418213,0.21056246757507324,100,adjust,flocet,1
HillValley,0.5148515105247498,1.3936069011688232,0.9489810466766357,100,adjust,flocet,1
HorseColic,0.720588207244873,0.7564716339111328,0.10962271690368652,100,adjust,flocet,1
IlpdIndianLiver,0.5753424763679504,1.6261444091796875,0.37304067611694336,100,adjust,flocet,1
ImageSegmentation,0.8061904907226562,0.7148683071136475,5.225852012634277,100,adjust,flocet,1
Ionosphere,0.7840909361839294,0.8008418083190918,0.3466980457305908,100,adjust,flocet,1
Iris,0.9729729890823364,0.361818790435791,0.1979842185974121,100,adjust,flocet,1
LedDisplay,0.7239999771118164,2.2575535774230957,0.3986086845397949,100,adjust,flocet,1
Lenses,0.8333333134651184,0.054601430892944336,0.0336155891418457,100,adjust,flocet,1
Letter,0.532800018787384,33.93412446975708,11.99417495727539,100,adjust,flocet,1
Libras,0.5333333611488342,0.5358772277832031,0.4755892753601074,100,adjust,flocet,1
LowResSpect,0.6992481350898743,1.4441733360290527,0.5881106853485107,100,adjust,flocet,1
LungCancer,0.125,0.07776427268981934,0.045542001724243164,100,adjust,flocet,1
Lymphography,0.837837815284729,0.3978993892669678,0.1984539031982422,100,adjust,flocet,1
Magic,0.7873817086219788,23.422428846359253,8.955044269561768,100,adjust,flocet,1
Mammographic,0.7833333611488342,1.2141799926757812,0.3826305866241455,100,adjust,flocet,1
Miniboone,0.2841985523700714,150.68180298805237,76.18495059013367,100,adjust,flocet,1
MolecBiolPromoter,0.7692307829856873,0.26253485679626465,0.1401522159576416,100,adjust,flocet,1
MolecBiolSplice,0.5909661054611206,5.4371256828308105,1.5671820640563965,100,adjust,flocet,1
Monks1,0.7384259104728699,0.4304370880126953,1.1343910694122314,100,adjust,flocet,1
Monks2,0.9282407164573669,0.45409417152404785,0.8160703182220459,100,adjust,flocet,1
Monks3,0.8726851940155029,0.26004624366760254,1.2922515869140625,100,adjust,flocet,1
Mushroom,0.9197439551353455,11.671864986419678,6.092984676361084,100,adjust,flocet,1
Musk1,0.6722689270973206,1.0292222499847412,0.6333572864532471,100,adjust,flocet,1
Musk2,0.8605215549468994,9.765278577804565,3.9055449962615967,100,adjust,flocet,1
Nursery,0.8987654447555542,17.89057970046997,8.994639873504639,100,adjust,flocet,1
OocytesMerlucciusNucleus4d,0.5529412031173706,1.474949598312378,0.39570116996765137,100,adjust,flocet,1
OocytesMerlucciusStates2f,0.8470588326454163,1.4776549339294434,0.40618133544921875,100,adjust,flocet,1
OocytesTrisopterusNucleus2f,0.6359649300575256,2.1158640384674072,0.8212311267852783,100,adjust,flocet,1
OocytesTrisopterusStates5b,0.8070175647735596,0.7977104187011719,0.3540971279144287,100,adjust,flocet,1
Optical,0.8269338011741638,6.055502414703369,5.035280704498291,100,adjust,flocet,1
Ozone,0.9337539672851562,3.895249605178833,0.9878325462341309,100,adjust,flocet,1
PageBlocks,0.8735380172729492,7.356528043746948,2.6700363159179688,100,adjust,flocet,1
Parkinsons,0.6530612111091614,0.4990408420562744,0.26303696632385254,100,adjust,flocet,1
Pendigits,0.8805031180381775,13.476584672927856,9.359235048294067,100,adjust,flocet,1
Pima,0.6979166865348816,1.424070119857788,0.30472874641418457,100,adjust,flocet,1
PittsburgBridgesMaterial,0.9230769276618958,0.2650625705718994,0.1397249698638916,100,adjust,flocet,1
PittsburgBridgesRelL,0.5384615659713745,0.25995469093322754,0.14011812210083008,100,adjust,flocet,1
PittsburgBridgesSpan,0.782608687877655,0.25025010108947754,0.12502574920654297,100,adjust,flocet,1
PittsburgBridgesTOrD,0.7599999904632568,0.18896818161010742,0.04090714454650879,100,adjust,flocet,1
PittsburgBridgesType,0.6153846383094788,0.313856840133667,0.14061498641967773,100,adjust,flocet,1
Planning,0.5777778029441833,0.5037086009979248,0.24353337287902832,100,adjust,flocet,1
PlantMargin,0.41999998688697815,1.9743199348449707,1.0761449337005615,100,adjust,flocet,1
PlantShape,0.19249999523162842,2.408484935760498,1.0916674137115479,100,adjust,flocet,1
PlantTexture,0.4000000059604645,3.118513345718384,1.1075677871704102,100,adjust,flocet,1
PostOperative,0.3636363744735718,0.24462246894836426,0.11887311935424805,100,adjust,flocet,1
PrimaryTumor,0.40243902802467346,1.0237884521484375,0.3617713451385498,100,adjust,flocet,1
Ringnorm,0.8664864897727966,8.613001108169556,4.408205032348633,100,adjust,flocet,1
Seeds,0.8461538553237915,0.5056488513946533,0.2781505584716797,100,adjust,flocet,1
Semeion,0.7185929417610168,2.541841983795166,0.6199750900268555,100,adjust,flocet,1
Soybean,0.7659574747085571,0.844606876373291,0.5983357429504395,100,adjust,flocet,1
Spambase,0.5991304516792297,5.667032480239868,2.2653002738952637,100,adjust,flocet,1
Spect,0.6612903475761414,0.24355363845825195,0.2923908233642578,100,adjust,flocet,1
Spectf,0.4491978585720062,0.27721500396728516,0.5704412460327148,100,adjust,flocet,1
StatlogAustralianCredit,0.5930232405662537,1.852691888809204,0.6824333667755127,100,adjust,flocet,1
StatlogGermanCredit,0.7200000286102295,1.834218978881836,0.6790709495544434,100,adjust,flocet,1
StatlogHeart,0.8805969953536987,0.5784227848052979,0.31845521926879883,100,adjust,flocet,1
StatlogImage,0.8752166628837585,3.9210317134857178,1.9188241958618164,100,adjust,flocet,1
StatlogLandsat,0.7325000166893005,10.010895729064941,5.085136890411377,100,adjust,flocet,1
StatlogShuttle,0.43524137139320374,69.80723524093628,29.39608097076416,100,adjust,flocet,1
StatlogVehicle,0.5071089863777161,1.0431628227233887,0.5902764797210693,100,adjust,flocet,1
SteelPlates,0.5876288414001465,2.463754415512085,0.8855204582214355,100,adjust,flocet,1
SyntheticControl,0.7866666913032532,0.7480196952819824,0.23315143585205078,100,adjust,flocet,1
Teaching,0.3684210479259491,0.4374241828918457,0.20568585395812988,100,adjust,flocet,1
Thyroid,0.9186114072799683,6.137523889541626,7.140101909637451,100,adjust,flocet,1
TicTacToe,0.7531380653381348,1.7441105842590332,0.3696584701538086,100,adjust,flocet,1
Titanic,0.774545431137085,3.0243136882781982,1.7289624214172363,100,adjust,flocet,1
Trains,1.0,0.024280309677124023,0.008002042770385742,100,adjust,flocet,1
Twonorm,0.930270254611969,8.182785987854004,3.402029514312744,100,adjust,flocet,1
VertebralColumn2Clases,0.7662337422370911,0.7945489883422852,0.12651777267456055,100,adjust,flocet,1
VertebralColumn3Clases,0.5454545617103577,0.7718594074249268,0.1785266399383545,100,adjust,flocet,1
WallFollowing,0.7243402004241943,5.941640138626099,3.6387112140655518,100,adjust,flocet,1
Waveform,0.7239999771118164,6.0811827182769775,3.6136348247528076,100,adjust,flocet,1
WaveformNoise,0.6904000043869019,6.5624847412109375,1.9926764965057373,100,adjust,flocet,1
Wine,0.9545454382896423,0.432279109954834,0.23597168922424316,100,adjust,flocet,1
WineQualityRed,0.48500001430511475,2.1698036193847656,0.6433055400848389,100,adjust,flocet,1
WineQualityWhite,0.3758170008659363,6.2530677318573,2.2181034088134766,100,adjust,flocet,1
Yeast,0.4501347839832306,1.9983916282653809,0.866572380065918,100,adjust,flocet,1
Zoo,1.0,0.24744653701782227,0.13568544387817383,100,adjust,flocet,1
